14 14 14 14 14 14 14 14 14 36 14 14 14 14 14 14 14 14 14 14 14 36 36 36 14 14 14 14 14 14 14 14 36 36 36 14 14 14 14 14 36 36 36 14 14 14 14 14 14 14 14 14 14 14 14 14 14 14 14 14 14 36 36 36 
14 14 14 14 14 14 14 14 14 36 36 36 14 14 36 36 36 36 14 14 14 14 14 36 36 14 14 14 14 14 14 14 14 14 14 14 31 31 31 31 31 31 31 31 31 31 31 31 31 31 31 31 31 14 14 14 36 36 36 36 36 14 14 14 
14 14 14 14 14 14 36 14 14 14 14 14 14 14 14 14 14 14 14 14 14 14 14 14 14 14 14 14 14 14 14 31 31 31 31 31 31 31 31 31 31 31 31 31 31 31 31 33 33 33 33 33 33 31 14 14 14 14 14 14 14 14 14 14 
14 14 14 36 36 14 36 14 14 14 31 31 31 31 31 14 14 14 14 14 14 14 31 31 31 31 31 31 31 31 31 31 31 31 31 31 31 31 31 31 31 31 33 33 33 33 33 33 40 40 40 40 33 31 31 14 14 14 36 36 36 14 14 14 
14 14 14 14 36 14 14 14 14 14 31 31 31 31 31 31 31 31 31 31 31 31 31 31 11 17 40 40 40 40 40 40 40 40 40 40 40 40 40 40 40 40 40 33 33 33 33 33 33 40 40 40 40 31 31 14 14 14 14 14 36 14 14 14 
14 14 14 14 36 36 14 14 14 14 31 31 31 31 31 31 31 31 31 31 31 31 31 40 40 40 40 40 40 40 20 20 20 20 20 20 45 40 40 40 40 40 40 33 33 33 33 33 33 33 40 40 40 31 31 31 14 14 14 14 14 14 14 14 
14 14 14 14 14 36 14 14 14 14 31 31 31 31 31 31 31 31 31 31 11 40 40 40 44 42 14 14 14 14 14 14 14 14 14 14 19 20 45 40 40 40 40 40 40 33 33 33 33 33 40 40 40 31 31 31 14 14 14 14 14 14 36 36 
14 14 14 14 14 14 14 14 14 14 31 31 31 31 31 31 31 31 31 11 40 40 11 44 21 14 14 14 14 14 14 14 14 14 14 14 14 14 10 33 40 40 40 40 40 40 40 40 40 40 40 40 40 31 31 31 14 14 14 14 36 36 36 14 
14 14 14 36 14 14 14 14 14 14 31 31 11 11 11 11 40 40 40 40 40 11 11 18 11 14 14 14 14 14 14 14 36 14 14 36 14 14 19 20 20 45 12 33 33 33 33 33 33 40 40 31 31 31 31 31 14 14 14 14 14 14 14 14 
14 14 14 14 36 14 14 14 14 14 31 11 11 11 40 40 40 40 40 40 40 11 11 18 11 14 36 14 14 14 14 14 14 14 14 14 14 14 14 14 14 10 53 3 33 33 33 33 40 40 40 40 31 31 31 31 31 14 14 14 14 14 14 14 
14 14 14 14 36 36 14 14 14 14 11 11 11 40 40 40 40 40 40 40 40 11 11 18 15 14 14 14 14 14 36 14 14 14 14 14 14 14 14 14 14 10 17 53 2 3 33 33 40 40 40 40 40 31 31 31 31 31 14 14 14 36 36 36 
14 14 14 14 14 36 14 14 14 11 11 11 40 40 40 40 40 40 40 40 40 11 11 18 15 14 14 14 14 14 14 14 14 14 14 14 14 14 14 14 14 10 28 29 30 12 33 33 40 40 40 40 40 31 31 31 31 31 31 14 14 14 14 14 
14 14 36 14 14 14 14 14 14 11 11 40 40 40 40 40 40 40 40 11 11 11 11 18 15 14 36 14 14 14 14 14 14 14 14 14 14 36 14 14 14 10 37 38 39 12 33 33 33 40 40 40 40 40 31 31 31 31 31 14 14 14 14 14 
14 14 36 36 14 14 14 14 14 11 11 40 40 40 40 40 17 17 11 11 11 17 11 18 15 14 14 14 14 14 14 14 14 14 14 14 14 14 14 14 14 10 46 47 48 53 3 33 33 33 33 40 40 40 40 40 31 31 31 14 14 14 14 14 
14 14 36 36 36 14 14 14 31 11 11 40 40 40 40 40 17 28 29 30 11 17 11 18 15 14 14 14 36 14 14 14 14 36 14 14 14 14 14 14 14 10 11 28 29 30 12 33 33 33 33 33 40 40 40 40 31 31 31 14 14 14 14 14 
14 14 36 14 14 14 14 14 31 11 11 40 40 40 17 17 17 37 38 39 11 17 34 18 51 6 14 14 14 14 14 14 14 14 14 14 14 14 14 14 14 10 11 37 38 39 12 33 33 33 33 33 40 40 40 40 33 31 31 14 14 14 14 14 
14 14 14 14 14 14 31 31 31 11 11 40 40 40 17 17 17 46 47 48 11 17 11 53 9 51 6 14 14 14 14 14 14 14 14 14 36 36 14 14 1 54 11 46 47 48 12 33 33 33 33 33 40 40 40 40 33 31 31 14 14 36 36 36 
14 14 14 14 14 31 31 31 31 11 11 40 40 40 17 17 17 17 17 11 17 11 11 11 53 8 8 8 8 9 14 14 14 14 14 14 14 14 14 1 54 11 28 29 30 11 12 33 33 33 33 33 33 40 33 33 33 31 31 14 14 14 14 14 
14 36 14 14 14 31 31 31 31 11 17 11 40 40 17 17 17 17 17 11 28 29 30 11 11 11 11 11 40 18 5 6 14 14 14 14 14 40 40 10 11 17 37 38 39 44 21 33 33 33 33 33 33 40 33 33 33 33 31 31 14 14 14 14 
14 36 14 14 14 40 31 31 31 11 17 11 17 11 17 17 17 17 17 11 37 38 39 11 11 11 11 11 11 18 40 51 5 5 5 5 44 40 40 19 45 17 46 47 48 12 33 33 33 33 33 33 33 40 33 33 33 33 31 31 14 14 14 14 
14 36 14 14 14 40 40 31 31 11 17 11 17 11 17 17 17 17 17 17 46 47 48 11 11 11 11 11 11 18 40 11 11 11 11 11 12 40 11 33 19 20 20 20 20 21 33 33 33 33 33 33 33 40 50 50 50 50 50 31 31 14 14 14 
14 14 36 14 14 40 40 31 11 11 17 11 17 11 17 17 17 17 17 17 17 17 11 17 11 11 11 11 11 18 40 11 11 44 20 20 21 40 40 33 33 33 33 33 33 1 2 2 3 33 33 50 50 40 50 28 29 30 50 31 31 14 14 14 
14 14 36 31 14 14 40 31 11 11 17 11 17 11 17 17 17 17 17 17 17 17 11 17 11 11 11 11 11 18 40 17 44 21 33 33 33 40 40 2 3 33 33 33 1 54 17 33 53 2 2 33 33 40 50 37 38 39 50 31 31 14 14 14 
14 31 31 31 31 14 40 40 31 11 17 17 11 17 17 28 29 30 17 11 17 17 11 11 11 11 11 11 11 18 40 11 12 31 33 33 33 33 40 17 53 2 2 2 54 17 17 33 28 29 30 33 33 40 50 46 47 48 50 31 31 14 14 14 
17 17 14 31 31 14 14 40 31 40 40 17 11 17 11 37 38 39 17 11 28 29 30 11 11 11 11 11 11 18 19 20 21 31 31 31 33 33 40 11 11 17 28 29 30 17 33 33 37 38 39 33 33 40 50 50 33 50 50 31 31 36 36 14
17 17 14 31 31 31 14 40 31 45 11 17 11 11 11 46 47 48 17 11 37 38 39 17 11 11 11 11 11 18 31 31 31 31 31 31 33 33 40 11 11 17 37 38 39 33 33 33 46 47 48 33 33 40 33 33 33 33 33 31 14 14 14 14 
17 17 28 29 30 31 14 31 31 25 26 45 11 11 11 17 17 17 17 17 46 47 48 17 11 11 11 11 11 18 31 31 31 31 31 31 33 33 40 11 11 11 46 47 48 33 28 29 30 33 33 33 33 40 33 33 33 33 31 31 14 14 14 14 
17 17 37 38 39 31 14 31 31 31 11 16 11 11 11 17 17 28 29 30 17 17 17 17 11 11 11 11 11 18 31 31 31 31 31 31 33 33 40 28 29 30 40 40 40 40 37 38 39 33 33 33 40 40 33 33 33 33 31 14 14 36 14 14 
17 17 46 47 48 31 14 31 31 31 11 25 45 11 11 17 17 37 38 39 17 28 29 30 11 11 11 11 11 18 31 31 31 31 31 31 33 40 40 37 38 39 40 40 40 40 46 47 48 33 33 33 40 33 33 33 33 33 31 14 14 36 36 14 
17 17 11 11 53 3 14 31 31 31 11 11 16 11 11 17 17 46 47 48 17 37 38 39 11 11 11 11 11 18 31 31 31 31 31 31 33 40 40 46 47 48 40 40 40 33 33 33 33 33 40 40 40 33 33 33 33 33 31 14 14 14 36 14 
31 19 20 20 45 12 14 31 31 31 11 17 25 45 11 17 17 17 17 17 17 46 47 48 17 11 11 11 11 18 31 31 31 31 31 31 33 40 40 40 40 40 40 40 40 40 40 40 40 40 40 40 33 33 33 33 33 33 31 14 14 14 14 14 
14 31 31 31 19 21 14 31 31 31 11 17 11 25 26 26 26 26 26 26 26 26 26 26 26 26 26 26 26 27 31 31 31 31 31 31 33 33 33 33 33 33 33 33 33 33 33 33 33 33 33 33 33 33 33 33 33 33 31 14 14 36 14 36 
14 14 14 31 31 31 14 31 31 31 11 11 17 11 11 11 17 17 17 17 11 17 17 11 11 17 31 31 31 31 31 31 31 31 31 31 33 33 33 33 33 33 33 33 33 33 33 33 33 33 33 33 33 33 33 33 33 33 31 14 14 36 14 14 
14 14 14 31 31 31 14 31 31 31 11 11 17 11 11 11 17 17 17 17 17 17 17 11 11 11 31 31 31 31 31 31 31 31 31 31 31 33 33 33 33 33 33 33 33 33 33 33 33 33 33 33 33 33 33 33 33 33 31 14 14 36 14 14 
14 14 14 14 31 31 14 31 31 31 11 11 17 11 11 11 17 17 17 17 17 11 17 11 11 11 31 31 31 31 31 31 31 31 31 31 31 33 33 33 40 40 40 40 40 40 40 40 40 40 40 40 40 40 33 33 33 33 31 14 14 14 14 14 
14 14 14 14 14 14 14 31 31 31 31 31 11 17 11 11 17 11 17 17 17 17 17 17 11 11 17 31 31 31 31 31 31 31 31 31 31 31 33 33 40 40 40 40 40 40 40 40 49 49 49 49 40 40 33 33 33 33 31 14 14 14 36 14 
14 36 14 14 14 14 14 31 31 31 31 31 11 17 11 11 11 17 17 17 17 17 17 17 11 11 11 31 31 31 31 31 31 31 31 31 31 31 31 31 40 40 40 33 33 1 2 2 2 2 3 49 40 40 33 33 33 33 31 14 14 14 14 14 
14 14 36 14 14 14 14 31 31 31 31 31 11 11 17 11 11 17 11 17 17 17 17 11 17 11 11 17 31 31 31 31 31 31 31 31 31 31 31 31 40 40 40 33 40 40 40 42 23 43 53 3 40 40 40 33 33 33 33 14 14 14 14 14 
14 14 36 14 14 14 14 14 31 31 31 31 11 40 40 40 40 40 40 40 40 40 40 40 40 40 40 40 40 40 31 31 31 31 31 31 31 31 31 31 40 40 33 33 33 40 42 24 14 22 43 12 40 40 40 40 33 33 33 14 14 14 14 14 
14 14 36 14 14 14 14 14 31 31 31 40 40 40 40 40 40 40 40 40 40 40 40 40 40 40 40 40 40 40 31 31 31 31 31 31 31 31 31 31 40 40 40 33 33 33 15 14 36 14 13 12 40 40 40 40 33 33 33 14 14 14 14 14 
14 14 14 14 14 14 14 14 14 31 31 40 40 40 40 40 40 28 29 30 40 40 40 40 40 40 40 40 40 40 31 31 31 31 31 31 31 31 31 31 40 40 33 50 33 33 15 14 14 4 52 12 40 40 40 40 33 33 34 33 33 14 14 14 
14 14 14 14 14 14 14 14 14 31 31 31 40 40 40 11 11 37 38 39 11 17 17 17 17 17 11 17 40 40 11 31 31 31 31 31 31 31 31 40 40 40 33 33 50 33 51 17 17 52 44 21 40 40 40 40 33 33 34 33 33 36 14 14 
14 14 14 36 14 14 14 14 14 14 31 31 31 40 31 11 11 46 47 48 11 17 17 17 17 17 17 11 40 40 17 11 31 31 31 31 31 31 31 40 40 40 33 33 1 3 33 33 33 19 21 33 40 40 40 40 33 33 33 33 14 14 36 14 
14 14 14 36 14 14 14 14 14 14 14 31 31 31 31 11 11 11 11 11 11 11 17 17 17 17 17 17 40 40 17 17 11 11 31 31 31 31 31 40 40 33 1 2 54 12 33 1 3 33 33 33 40 40 40 40 33 33 33 33 33 14 14 14 
14 14 14 14 36 36 14 14 14 14 14 31 31 31 31 31 31 31 31 11 11 11 17 17 17 17 17 17 40 40 17 17 17 11 11 31 31 31 31 40 40 17 44 20 20 21 1 49 53 3 33 40 40 40 40 33 33 33 33 33 33 14 36 14 
14 14 14 14 36 14 14 14 14 14 14 31 31 31 31 31 31 31 31 11 28 29 30 17 17 17 11 17 40 40 17 11 17 17 11 11 31 31 31 40 40 20 21 33 33 33 19 11 17 12 40 40 40 40 33 34 34 33 33 33 33 14 14 14 
14 14 14 14 36 36 14 14 14 14 14 14 31 31 31 31 31 31 31 11 37 38 39 11 17 17 17 17 40 40 17 11 17 17 11 11 11 11 31 40 40 33 40 45 33 33 33 11 44 21 40 40 40 40 50 50 50 50 50 33 33 14 14 14 
14 14 14 14 14 36 36 36 14 14 14 14 14 31 31 31 31 31 31 31 46 47 48 11 11 17 17 17 40 40 17 17 17 11 17 11 11 11 11 40 40 33 33 19 45 40 33 17 33 33 40 40 40 33 50 28 29 30 50 33 33 14 36 14 
14 14 14 14 14 14 14 14 14 14 14 14 14 31 31 31 31 31 31 31 31 31 11 11 11 11 11 17 40 40 17 17 17 17 17 17 17 17 11 40 40 33 33 33 10 40 17 17 33 40 40 40 40 34 50 37 38 39 50 33 33 14 14 14 
14 14 14 14 14 36 14 14 14 14 14 14 14 14 31 31 31 31 31 31 31 31 11 11 11 28 29 30 40 40 17 17 17 17 17 17 17 17 17 40 40 33 33 1 54 33 50 17 33 40 40 34 33 33 50 46 47 48 50 33 33 14 36 14 
14 14 14 14 14 36 36 14 14 14 14 14 14 14 14 31 31 31 31 31 31 31 11 11 11 37 38 39 40 40 17 17 17 17 17 17 17 17 17 40 40 2 2 54 33 40 17 33 33 40 33 34 33 50 50 50 50 50 50 50 33 14 14 14 
14 14 14 14 14 14 14 14 14 14 14 14 14 14 14 14 31 31 31 31 31 31 31 11 11 46 47 48 40 40 17 17 49 49 17 49 49 11 17 40 40 44 20 45 40 17 33 40 40 40 34 34 50 33 50 33 33 33 33 33 33 14 14 36
14 14 14 14 14 14 14 14 14 14 14 14 14 14 14 14 14 31 31 31 31 31 31 31 31 11 11 11 40 40 17 11 49 28 29 30 49 17 17 40 40 40 33 19 45 40 40 40 40 33 34 50 50 33 33 33 33 14 14 14 50 14 14 14 
14 14 14 14 14 14 14 36 36 14 14 14 14 14 14 14 14 14 31 31 31 31 31 31 31 31 31 11 40 40 11 11 49 37 38 39 49 17 17 40 40 33 50 33 10 33 40 33 33 33 50 50 33 33 33 14 14 14 14 14 14 14 14 14 
14 14 14 14 14 14 14 14 36 36 14 14 14 14 14 14 14 14 31 31 31 31 31 31 31 31 31 31 40 40 11 11 49 46 47 48 49 17 11 40 40 40 33 1 54 40 40 33 50 50 50 33 31 31 14 14 14 14 14 14 14 36 14 14 
14 14 14 14 14 14 14 14 36 36 14 14 14 14 14 14 14 14 14 14 14 31 31 31 31 31 31 31 40 40 11 11 49 49 49 49 49 11 17 40 40 33 1 54 40 40 40 33 50 33 33 31 14 14 14 14 14 14 36 14 14 14 14 14 
14 14 14 36 14 14 14 14 36 14 14 14 14 14 14 14 14 14 14 14 14 14 14 14 14 31 31 31 40 40 31 31 31 31 11 11 11 11 11 40 40 2 31 31 31 40 40 33 33 33 33 31 14 14 14 14 14 36 14 36 14 36 14 14 
14 14 14 36 14 14 14 14 36 36 36 36 36 14 14 14 14 14 14 14 36 14 14 14 14 14 14 14 14 14 14 31 31 31 31 31 31 31 31 40 40 40 40 40 31 31 31 31 14 14 14 14 14 14 14 36 36 14 36 14 14 14 36 14 
14 14 14 36 14 14 14 14 36 14 14 14 14 14 14 14 14 14 14 14 14 36 36 14 14 14 14 14 14 14 14 14 14 14 14 14 14 14 14 14 14 36 14 14 14 14 14 14 14 36 14 14 14 14 36 14 14 36 14 14 14 14 36 14 
14 14 14 36 36 14 14 14 36 14 14 14 14 14 14 14 14 14 36 36 14 14 14 36 14 14 14 14 36 36 14 14 14 14 14 14 14 14 14 14 14 14 14 36 14 14 36 14 14 14 14 14 14 14 14 36 14 14 14 14 36 14 36 36 
14 14 14 14 36 14 14 14 14 14 14 14 14 14 14 14 14 14 14 14 14 14 14 14 36 36 36 14 14 14 14 14 14 36 14 14 14 14 14 14 36 14 14 14 14 14 14 36 36 36 14 14 14 14 14 14 36 14 14 14 14 14 36 14 
14 14 14 14 36 36 14 14 14 14 14 14 36 36 36 36 14 14 14 14 14 14 14 14 14 14 14 14 14 36 14 14 14 14 36 36 36 14 14 14 14 14 14 14 14 14 14 14 14 14 14 14 36 14 14 14 14 14 14 14 14 14 14 14 
14 14 14 14 14 14 14 14 14 14 14 14 14 14 14 14 14 14 14 14 14 14 36 36 14 14 14 14 14 36 36 36 36 14 14 14 14 14 14 14 14 14 36 36 14 36 14 14 14 14 14 14 14 14 14 14 14 14 14 14 14 14 14 14 
14 14 14 14 14 14 14 14 14 14 14 14 14 14 14 14 14 14 14 14 14 14 14 14 14 14 14 14 14 14 14 14 14 14 14 14 36 36 36 36 36 36 36 14 14 14 14 14 14 14 14 14 14 14 14 14 14 14 14 14 14 14 14 14