0 0 0 0 0 0 0 0 0 0 0 0 0 0 0 0 0 0 0 0 0 0 0 0 0 0 67 0 0 0 0 0 0 0 0 0 0 0 0 0 0 0 0 67 0 0 0 0 0 0 0 0 0 0 0 0 0 0 0 0 0 0 0 0 
0 0 0 0 67 0 0 0 0 0 0 0 67 67 67 0 0 0 0 0 0 0 0 0 0 0 0 0 0 0 0 67 0 0 0 0 0 67 0 0 0 0 0 0 0 0 0 0 0 0 67 0 0 67 0 0 0 67 0 0 0 0 0 0 
0 0 0 0 0 0 0 0 67 0 0 0 67 0 0 0 0 0 67 0 7 8 8 8 8 8 8 8 8 8 8 8 8 8 8 8 8 8 8 8 8 8 8 8 8 8 8 8 9 0 0 0 0 0 0 0 0 0 0 0 0 0 0 0 
0 0 0 0 0 0 0 0 0 0 0 0 7 9 0 0 0 0 0 7 111 0 0 0 0 0 0 0 0 0 0 0 0 0 0 0 0 0 0 0 0 0 0 0 0 0 0 0 110 9 0 67 0 0 0 0 0 67 0 0 0 0 0 0 
0 0 0 67 0 0 0 0 0 0 0 7 111 110 8 8 8 8 8 111 0 0 0 0 0 0 0 0 0 0 0 0 0 0 0 0 0 0 0 0 0 0 0 0 0 0 0 0 0 110 8 9 0 0 0 67 0 0 0 0 0 0 0 0 
0 0 0 0 0 0 0 67 0 0 7 111 0 0 0 0 0 0 0 0 0 0 16 0 0 0 0 0 0 0 0 0 17 0 17 0 0 0 17 0 0 0 34 17 0 0 0 0 0 0 0 110 8 9 0 0 0 0 67 0 0 0 0 0 
0 0 0 0 0 0 0 0 0 7 111 0 0 0 0 0 0 0 0 0 16 0 0 0 0 16 0 0 0 0 0 0 17 17 0 14 37 0 17 0 0 14 0 0 0 0 16 0 0 0 0 0 0 110 9 0 0 0 0 0 0 0 0 0 
0 67 0 67 0 0 67 25 7 111 0 0 0 0 0 0 0 16 16 0 0 0 16 0 0 0 0 0 0 0 0 0 0 0 0 0 0 0 0 0 0 0 17 17 0 0 16 0 0 0 0 34 0 0 110 8 9 0 0 0 0 0 0 0 
0 0 0 0 0 0 7 8 111 16 0 0 0 0 0 0 0 17 16 0 0 0 0 0 0 16 0 10 0 0 0 0 10 37 0 0 0 0 0 0 0 36 0 17 17 17 17 36 0 0 0 0 17 0 0 0 110 8 9 0 0 67 0 0 
0 0 0 0 7 8 111 0 0 0 17 0 0 16 14 14 0 14 0 0 61 62 0 0 16 0 0 30 0 0 0 0 30 0 0 16 36 17 36 17 14 14 17 0 0 16 17 17 17 37 0 0 0 0 0 0 0 0 29 0 0 0 0 0 
0 0 0 0 27 0 0 0 0 0 0 14 0 0 0 17 0 0 0 0 81 82 0 0 0 0 0 30 0 95 0 0 30 0 0 0 17 17 14 14 0 0 0 16 36 0 16 16 36 14 0 0 0 0 0 0 0 0 29 0 0 0 0 0 
0 0 67 0 27 0 0 0 16 0 0 0 17 14 14 16 14 0 0 0 101 102 0 0 0 0 0 30 0 0 0 0 30 0 0 35 17 0 14 0 35 0 0 0 0 0 16 16 36 14 14 14 17 0 0 0 0 0 110 9 0 0 0 0 
0 0 0 0 27 0 0 0 0 15 17 0 0 14 15 14 0 61 62 0 17 0 17 0 63 64 0 30 0 0 96 0 30 0 0 0 0 0 0 0 0 0 0 34 0 0 16 16 0 16 0 14 17 14 0 0 0 0 0 29 0 0 0 0 
0 0 0 0 27 0 0 16 16 0 14 16 14 16 15 0 0 81 82 0 0 85 0 0 83 84 0 30 0 0 0 0 30 127 129 0 0 0 127 129 0 0 0 0 0 0 0 16 16 0 0 0 0 0 0 34 0 0 0 29 0 0 67 0 
0 0 0 0 27 0 16 0 17 0 14 0 0 17 17 17 0 101 102 63 64 0 0 0 103 104 0 30 0 94 0 0 30 147 148 129 0 0 147 149 0 0 0 14 0 0 0 35 0 0 36 14 0 36 0 0 0 37 0 29 0 0 0 0 
0 0 0 0 27 0 0 0 14 16 0 15 14 14 0 14 0 0 0 83 84 0 65 0 0 0 14 30 0 0 0 0 30 147 148 148 128 128 151 150 128 128 129 0 0 0 0 0 0 14 36 0 16 0 0 0 0 0 0 29 0 0 0 0 
0 0 0 0 27 0 14 0 0 0 17 17 0 0 0 0 0 85 0 103 104 17 0 0 14 0 0 30 0 0 95 0 30 147 148 148 148 148 148 148 148 148 150 128 128 129 0 0 0 0 14 0 16 0 0 0 0 0 0 110 9 0 0 0 
0 0 0 0 27 0 0 0 16 0 14 0 0 0 63 64 0 0 0 14 0 14 63 64 0 85 0 30 0 0 0 0 30 147 148 148 148 148 148 148 148 148 148 148 148 150 129 0 0 0 0 34 16 0 0 14 35 0 0 0 29 0 0 0 
0 0 0 0 27 15 17 0 0 15 0 16 14 0 83 84 0 14 0 0 17 0 83 84 0 0 0 30 0 0 0 0 30 147 148 148 148 148 148 148 148 148 148 148 148 148 148 129 0 0 0 0 0 0 0 14 0 34 0 0 29 0 0 0 
0 67 0 0 27 0 0 14 0 16 0 17 0 0 103 104 0 0 63 64 0 17 103 104 0 65 0 30 0 0 97 0 30 147 148 148 148 148 148 148 148 148 148 148 148 148 148 150 129 35 0 0 0 17 0 0 36 0 0 0 29 0 67 0 
0 0 0 0 27 0 0 14 0 0 0 0 0 0 17 14 0 17 83 84 17 17 0 0 17 0 0 30 0 0 0 0 30 147 148 148 148 148 148 148 148 148 148 148 148 148 148 170 169 0 0 0 0 34 16 36 36 0 0 0 29 0 0 0 
0 0 0 0 27 0 0 14 0 14 0 63 64 0 0 0 0 17 103 104 0 0 63 64 0 85 0 30 0 0 0 0 30 147 148 148 148 148 148 148 148 148 148 148 148 148 170 169 0 0 0 0 0 0 0 0 0 0 0 0 110 9 0 0 
0 0 0 0 27 15 0 0 0 0 0 83 84 17 17 85 63 64 0 85 17 14 83 84 17 17 17 30 0 94 0 0 30 147 148 148 148 148 148 148 148 148 148 148 148 148 171 128 128 128 129 0 14 0 0 14 0 0 0 0 0 29 0 0 
0 0 67 0 27 0 0 0 14 0 0 103 104 17 17 0 83 84 17 0 0 14 103 104 0 65 0 30 0 0 96 0 30 147 148 148 148 148 148 148 148 148 148 148 148 148 170 168 168 168 169 0 0 0 0 0 0 0 0 0 0 29 0 0 
0 0 0 0 27 0 0 0 61 62 0 65 0 61 62 0 103 104 0 65 65 0 63 64 17 17 0 30 0 0 0 0 30 147 148 148 148 148 148 148 148 148 148 148 148 148 149 0 0 0 0 0 0 0 34 0 0 0 0 0 0 29 0 67 
0 0 0 0 27 0 0 0 81 82 0 85 17 81 82 17 0 65 17 17 17 17 83 84 17 17 65 30 0 0 0 0 30 147 148 148 148 148 148 148 148 148 148 148 148 170 169 0 0 0 0 0 0 0 0 0 0 34 0 0 0 29 0 0 
0 0 0 0 27 0 0 0 101 102 0 0 17 101 102 17 17 17 17 17 17 17 103 104 0 0 0 30 0 97 0 0 30 167 168 168 168 168 168 168 168 168 168 168 168 169 0 0 0 0 0 0 0 0 0 0 0 0 0 0 0 29 0 0 
0 67 67 0 27 0 71 72 72 72 72 72 72 72 72 72 72 72 72 72 72 72 72 72 72 72 72 53 0 0 0 0 51 72 72 72 72 72 72 72 72 72 72 72 72 72 72 72 72 72 72 72 72 73 0 0 0 0 0 0 0 29 0 0 
0 0 0 0 27 0 0 0 0 0 0 0 0 0 0 0 0 0 0 0 0 0 0 0 0 0 0 0 0 0 0 0 0 0 0 0 0 0 0 0 0 0 0 0 0 0 0 0 0 0 0 0 0 0 0 0 0 0 0 0 0 29 0 0 
0 0 0 0 27 0 0 0 0 0 95 0 97 0 0 0 0 0 95 0 0 96 0 0 0 0 0 96 0 0 0 0 0 96 0 0 0 95 0 0 0 0 94 0 0 0 0 97 0 0 0 0 0 0 0 0 0 0 0 0 0 29 0 0 
0 0 0 0 27 0 0 94 0 0 0 96 0 0 97 0 0 0 0 97 0 0 0 94 0 0 0 0 0 94 0 0 0 0 0 0 0 95 0 0 0 0 0 0 0 0 94 0 0 0 96 0 0 0 0 0 0 0 0 0 0 29 0 0 
0 0 0 0 27 0 0 0 0 0 0 0 0 0 0 0 0 0 0 0 0 0 0 0 0 0 0 0 0 0 0 0 0 0 0 0 0 0 0 0 0 0 0 0 0 0 0 0 0 0 0 0 0 0 0 0 0 0 0 0 90 49 0 0 
0 0 67 0 27 0 71 72 72 72 72 72 72 72 72 72 72 72 72 72 72 72 72 72 72 72 72 13 0 97 0 0 11 72 72 72 72 72 72 72 72 72 72 72 72 72 72 72 72 72 72 72 72 73 112 0 0 0 0 0 29 0 67 0 
0 0 0 0 27 0 0 0 0 7 8 8 8 8 8 8 8 8 8 8 8 8 8 8 8 8 9 30 0 0 0 0 30 4 5 5 5 5 5 5 5 5 5 5 5 5 5 6 0 0 0 0 0 0 0 0 0 0 0 0 29 0 0 0 
0 0 0 0 27 0 0 0 0 27 7 8 8 8 8 8 8 8 8 8 8 8 8 8 8 9 29 30 0 0 0 0 30 24 25 25 25 25 25 145 25 25 25 25 25 25 25 26 0 0 0 0 0 0 0 55 0 0 0 0 29 0 0 0 
0 0 0 0 27 0 0 0 0 27 27 7 8 8 8 8 8 8 8 8 8 8 8 8 9 29 29 30 0 94 0 0 30 24 25 67 25 122 25 25 25 25 143 25 143 25 25 26 0 0 0 0 0 0 0 0 0 0 57 0 29 0 0 0 
0 0 0 0 27 0 0 0 0 27 27 27 54 54 54 54 55 54 55 54 56 54 54 54 29 29 29 30 0 0 0 0 30 24 25 141 25 25 25 67 25 25 67 25 25 67 25 26 0 0 0 0 0 55 0 0 0 0 0 0 29 0 67 0 
0 67 0 0 27 0 0 0 0 27 27 27 54 54 56 54 54 55 54 54 54 55 56 54 29 29 29 30 0 0 0 0 30 24 25 25 25 126 25 25 25 25 146 25 25 25 25 26 55 0 0 0 0 0 0 0 0 57 0 0 29 0 0 0 
0 0 0 0 27 0 0 0 0 27 27 27 54 56 54 75 75 54 75 75 54 54 55 54 29 29 29 30 0 97 0 0 30 24 25 25 25 25 25 25 142 25 25 25 25 144 25 26 0 0 0 0 0 0 0 0 0 0 0 0 29 0 0 0 
0 0 0 0 27 0 0 0 0 27 27 27 55 56 75 75 75 75 75 75 75 54 55 54 29 29 29 30 0 0 0 0 30 24 25 25 145 67 25 25 25 25 25 67 25 25 25 26 0 0 0 0 74 0 0 0 0 74 0 0 29 0 67 0 
0 0 67 0 27 0 0 0 0 27 27 27 56 54 75 75 75 75 75 75 75 55 55 54 29 29 29 30 0 0 96 0 30 24 143 25 25 25 25 25 25 25 25 25 25 124 25 26 0 57 0 0 74 0 0 0 0 0 0 0 29 0 0 0 
0 0 0 0 27 0 0 0 0 27 27 27 54 54 54 75 75 75 75 75 54 56 54 54 29 29 29 30 0 0 0 0 30 24 25 25 25 25 25 25 67 25 146 25 145 25 25 26 0 0 0 0 0 0 0 0 0 0 0 0 29 0 0 0 
0 0 0 0 27 0 0 0 0 27 27 27 56 54 56 54 75 54 75 54 55 54 55 54 29 29 29 30 0 0 0 0 30 24 25 67 25 125 25 25 25 25 25 25 25 25 25 26 0 0 0 0 0 0 0 55 0 0 0 90 49 0 0 0 
0 0 0 0 27 0 0 0 0 27 27 27 57 55 57 55 57 75 57 57 56 57 55 55 29 29 29 30 0 0 95 0 30 24 25 25 25 25 25 25 25 25 25 25 25 25 25 26 0 0 0 55 0 0 0 0 0 54 0 29 0 0 0 0 
0 0 0 0 47 91 0 0 0 27 27 47 48 48 48 48 48 48 48 48 48 48 48 48 49 29 29 30 0 0 0 0 30 24 25 67 67 145 25 25 67 25 121 25 67 25 144 26 0 0 0 0 0 0 0 0 74 0 0 29 0 0 0 0 
0 0 0 0 0 27 0 0 0 27 47 48 48 48 48 48 48 48 48 48 48 48 48 48 48 49 29 30 0 0 0 0 30 24 25 146 25 25 25 25 25 25 25 25 25 25 25 26 0 0 0 0 75 0 0 56 0 0 0 29 0 0 67 0 
0 0 0 0 0 47 91 0 0 47 48 48 48 48 48 48 48 48 48 48 48 48 48 48 48 48 49 30 0 96 0 0 30 44 45 45 45 45 45 45 45 45 45 45 45 45 45 46 0 0 0 55 0 0 0 0 0 0 0 29 0 0 0 0 
0 0 67 0 0 0 27 0 0 0 0 0 0 0 0 0 0 0 0 0 0 0 0 57 0 0 0 30 0 0 0 0 30 0 0 0 0 0 0 0 0 0 0 0 0 0 0 0 0 0 0 0 0 54 0 0 0 0 0 29 0 0 0 0 
0 0 0 0 0 0 27 0 0 0 0 0 0 0 0 0 0 77 0 0 0 0 0 0 0 0 0 30 0 0 0 0 30 0 0 0 55 0 0 0 0 0 0 0 0 0 0 0 0 0 57 0 0 0 55 75 0 0 90 49 0 0 0 0 
0 0 0 0 0 0 27 0 0 0 0 56 0 77 0 0 0 56 0 0 0 0 0 75 0 0 0 30 0 0 0 0 30 0 0 0 0 0 0 0 57 0 0 0 75 0 0 0 54 0 0 0 77 0 56 0 0 0 29 0 0 0 0 0 
0 0 0 67 0 0 27 0 0 0 0 0 0 0 0 0 56 0 0 0 0 0 0 0 0 57 0 30 0 0 0 0 30 0 0 0 0 75 0 0 0 0 0 0 55 56 0 77 0 0 0 0 0 0 0 0 0 0 29 0 0 0 0 0 
0 0 67 0 0 0 47 91 0 0 0 0 57 0 77 0 0 0 0 0 77 57 0 0 0 0 0 30 0 95 0 0 30 0 0 0 0 0 0 55 0 74 0 0 0 0 0 0 0 0 0 0 74 57 0 0 75 0 29 0 0 67 0 0 
0 0 67 0 0 0 0 27 0 0 0 0 0 0 0 0 0 0 0 77 0 0 0 0 0 0 0 30 0 0 0 0 30 0 0 0 0 0 55 0 56 0 57 0 0 0 0 75 55 0 0 0 0 0 0 0 0 0 29 0 0 0 0 0 
0 0 0 0 0 0 0 27 0 0 0 0 0 0 0 55 0 0 74 0 0 0 0 0 0 0 0 30 0 0 97 0 30 0 0 0 0 0 0 0 0 0 0 0 77 0 0 0 0 0 55 0 0 0 0 0 0 0 29 0 0 0 0 0 
0 0 0 0 0 0 0 27 0 0 0 0 77 56 0 0 0 0 0 0 0 0 0 75 0 0 0 30 0 0 0 0 30 0 0 0 0 0 0 0 0 0 0 0 0 0 55 0 0 0 56 0 0 0 0 75 57 0 29 0 0 0 0 0 
0 67 0 67 0 0 0 47 0 0 0 0 0 0 0 0 0 0 56 0 0 0 0 0 0 0 0 50 0 0 0 0 50 0 0 0 0 57 0 75 0 74 0 0 0 0 0 0 0 0 0 0 0 0 0 75 0 0 29 0 0 0 0 0 
0 0 0 0 0 0 0 0 27 0 0 0 0 77 0 0 57 0 0 0 0 57 0 0 0 56 56 0 0 0 0 0 0 0 0 0 0 0 0 0 0 0 0 0 0 0 0 0 0 75 0 0 0 0 0 0 0 0 29 0 67 67 0 0 
0 0 0 0 0 0 0 0 47 48 91 0 0 0 0 0 0 0 0 0 0 0 0 0 0 0 56 0 0 0 0 74 0 0 0 0 0 0 0 0 0 0 0 0 0 57 0 0 0 0 0 0 57 0 0 0 0 0 29 0 0 67 0 0 
0 0 0 0 0 0 0 0 0 0 47 91 0 0 0 0 0 0 0 0 0 0 0 0 0 0 0 0 0 0 0 0 0 0 0 0 0 0 0 0 0 0 0 0 0 0 0 0 0 0 0 0 0 0 0 0 0 90 49 0 0 0 0 0 
0 0 67 0 0 0 0 0 0 0 0 47 48 48 48 91 0 0 0 0 0 0 0 0 0 0 0 0 0 0 0 0 0 0 0 0 0 0 0 0 0 0 0 0 0 0 0 0 0 0 0 0 0 0 0 0 0 29 0 0 0 0 0 0 
0 0 0 0 0 67 0 0 0 0 0 0 0 0 0 47 48 48 48 48 48 48 48 48 48 91 0 0 0 0 0 0 0 0 0 0 0 0 0 0 0 0 0 0 0 0 0 0 0 0 0 0 0 0 0 0 0 29 0 0 0 67 0 0 
0 0 0 0 0 0 0 67 67 67 67 0 0 0 0 0 0 0 0 0 0 0 0 0 67 47 48 48 48 48 48 48 48 48 48 48 48 48 48 48 91 0 0 0 90 48 48 48 48 48 48 48 48 48 48 91 90 49 0 0 0 67 0 0 
0 67 0 0 0 0 0 0 0 0 67 67 0 0 0 0 0 0 67 0 0 0 0 0 67 0 0 0 67 0 0 0 0 0 0 67 0 0 0 0 47 48 48 48 49 0 0 0 0 0 0 0 0 0 0 47 49 0 67 0 0 67 0 0 
0 0 0 0 0 0 0 0 0 0 0 0 0 0 0 0 0 0 67 67 0 0 0 0 0 0 0 0 0 0 0 0 0 67 0 0 0 0 0 0 0 0 0 0 0 0 0 67 0 0 67 0 0 0 0 0 0 0 0 0 0 0 0 0