25 25 25 25 25 25 25 25 25 25 25 25 25 25 25 25 25 25 25 25 25 25 25 25 25 25 25 25 25 25 25 25 25 25 25 25 25 25 25 25 25 25 25 25 25 25 25 25 25 25 25 25 25 25 25 25 25 25 25 25 25 25 25 25 
25 25 25 25 25 25 25 25 25 25 25 25 25 25 25 25 25 25 25 25 25 25 25 25 25 25 25 25 25 25 25 25 25 25 25 25 25 25 25 25 25 25 25 25 25 25 25 25 25 25 25 25 25 25 25 25 25 25 25 25 25 25 25 25 
25 25 25 25 25 25 25 25 25 25 25 25 25 25 25 25 25 25 25 25 25 25 25 86 45 45 45 45 45 45 45 45 45 45 45 45 45 87 25 25 25 25 25 25 25 25 25 25 25 25 25 25 25 25 25 25 25 25 25 25 25 25 25 25 
25 25 25 25 25 25 25 25 25 25 25 25 25 25 25 25 25 25 25 25 25 25 86 46 0 0 0 0 0 0 0 0 0 0 0 0 0 44 45 87 25 25 25 25 25 25 25 25 25 25 25 25 25 25 25 25 25 25 25 25 25 25 25 25 
25 25 25 25 25 25 25 25 25 25 25 25 25 25 25 25 25 25 25 25 25 86 46 0 0 0 0 0 0 0 0 0 0 0 0 0 0 0 0 44 45 45 45 45 45 45 45 45 45 45 45 45 45 45 45 45 45 45 45 45 87 25 25 25 
25 25 25 25 25 25 86 45 45 45 45 45 45 45 45 45 45 45 45 45 45 46 0 0 0 0 0 0 0 0 0 0 0 0 0 0 0 0 0 0 0 0 0 0 0 0 0 0 0 0 63 64 0 0 0 0 0 0 0 0 44 87 25 25 
25 25 25 25 25 25 26 0 0 0 0 0 0 0 0 0 0 0 0 0 0 0 0 0 0 0 0 0 0 0 0 0 0 0 0 0 0 0 0 0 0 0 0 0 0 0 0 0 63 64 83 84 0 0 65 65 65 65 65 0 0 24 25 25 
25 25 25 25 25 25 26 0 0 0 0 0 0 0 0 0 0 0 0 0 0 0 0 11 72 13 0 0 0 0 0 0 0 0 0 0 0 0 0 0 0 0 0 0 0 0 0 0 83 84 103 104 65 65 0 0 0 0 65 65 0 24 25 25 
25 25 25 25 25 25 26 0 0 0 0 127 128 128 129 0 0 127 129 0 0 0 0 30 0 30 0 0 0 0 0 0 0 0 0 0 0 0 0 0 0 0 0 0 0 0 0 0 103 104 0 0 0 0 0 0 0 0 0 65 0 24 25 25 
25 25 25 25 25 25 26 0 0 0 127 151 148 148 150 128 128 151 149 0 0 0 51 33 0 30 0 0 0 0 0 0 0 0 0 0 0 0 0 0 0 0 0 0 0 63 64 61 62 0 0 0 0 0 0 0 0 0 0 65 0 24 25 25 
25 25 25 25 25 25 106 5 6 0 167 131 148 148 148 148 148 148 149 0 0 0 0 30 0 30 0 0 0 0 0 0 0 0 0 0 0 0 0 0 0 0 0 0 0 83 84 81 82 61 62 0 0 0 0 0 0 0 0 65 0 24 25 25 
25 25 25 25 25 25 25 25 26 0 0 167 131 148 148 148 148 148 149 0 0 0 11 53 0 51 13 0 0 0 0 0 0 0 0 0 0 0 0 0 0 0 0 0 65 103 104 101 102 81 84 0 0 0 0 0 0 0 0 65 0 24 25 25 
25 25 25 25 25 25 86 45 46 0 0 0 147 148 148 148 148 148 149 0 0 0 30 0 94 0 51 13 0 0 0 0 0 0 0 0 0 0 0 0 0 0 0 0 63 62 65 63 62 101 102 0 94 97 0 0 0 0 65 65 0 24 25 25 
25 25 25 25 25 25 26 0 0 0 0 0 167 131 130 168 168 168 169 0 0 11 53 0 0 0 0 51 13 0 0 0 0 0 0 0 0 0 0 0 0 0 0 0 83 84 0 81 82 0 0 0 0 96 0 0 0 0 65 65 0 24 25 25 
25 25 25 25 25 25 26 0 0 0 0 0 0 167 169 0 0 0 0 0 11 53 0 0 0 0 0 0 51 13 0 0 0 0 0 0 0 0 0 0 0 0 0 0 103 104 0 101 102 0 0 0 0 0 0 0 0 0 65 65 0 24 25 25 
25 25 25 25 25 25 26 0 0 0 0 0 0 0 0 0 0 0 0 11 53 0 0 0 0 0 0 0 0 51 13 0 0 0 0 0 0 0 0 0 0 0 0 0 0 0 0 0 0 0 0 0 0 0 0 0 0 0 0 0 4 107 25 25 
25 25 25 25 25 25 26 0 0 0 0 0 0 0 0 0 0 0 11 53 0 0 70 70 70 70 71 72 72 72 33 0 0 0 0 0 0 0 0 0 0 0 0 0 0 0 0 0 0 0 0 0 0 0 0 0 0 0 0 0 24 25 25 25 
25 25 25 25 25 25 26 0 0 0 0 0 0 0 0 0 0 11 53 0 0 0 10 0 0 0 0 0 0 0 30 0 0 0 0 0 0 0 0 0 0 0 0 0 0 0 0 0 0 0 94 0 0 0 0 85 0 0 0 0 24 25 25 25 
25 25 25 25 25 25 106 6 0 0 0 0 0 0 0 0 0 10 0 0 0 0 51 72 72 72 72 72 72 72 53 0 0 0 0 0 0 0 0 0 0 0 96 0 0 85 85 85 85 85 0 95 0 0 85 85 85 0 0 0 24 25 25 25 
25 25 25 25 25 25 25 26 0 0 0 0 0 0 0 0 0 30 0 0 0 0 0 0 0 0 0 0 0 0 0 0 0 0 0 0 0 0 0 0 0 0 0 0 0 0 0 85 85 85 0 94 85 85 0 0 85 0 0 0 24 25 25 25 
25 25 25 25 25 25 25 26 0 0 0 0 0 0 0 0 0 30 0 94 0 0 0 0 0 0 0 0 0 0 0 4 6 0 0 0 0 0 0 0 0 0 0 0 0 0 0 0 0 85 85 0 85 0 0 0 0 0 0 4 107 25 25 25 
25 25 25 25 25 25 25 26 0 0 0 0 0 0 0 0 0 30 0 0 0 0 0 0 0 0 96 0 0 0 0 24 26 0 0 0 0 0 0 0 0 0 0 0 0 0 0 0 0 0 85 85 85 0 0 0 0 0 0 24 25 25 25 25 
25 25 25 25 25 25 25 26 0 0 0 0 0 0 0 0 0 30 0 0 0 0 0 0 0 0 0 0 0 0 0 24 106 6 0 0 0 0 0 0 0 0 0 0 0 0 0 0 0 0 0 0 0 0 0 0 0 0 0 24 25 25 25 25 
25 25 25 25 25 25 25 26 0 0 0 0 0 0 0 0 0 50 0 0 0 0 0 0 0 0 0 0 0 0 0 24 25 26 0 0 0 0 0 0 0 0 0 0 0 11 72 72 72 72 72 72 72 72 13 0 0 0 0 24 25 25 25 25 
25 25 25 25 25 25 25 26 0 0 0 0 0 0 0 0 0 0 0 0 0 0 0 0 0 0 0 0 0 0 4 107 25 106 6 0 0 0 0 0 0 0 0 0 0 30 0 0 0 0 0 0 0 0 30 0 0 0 0 24 25 25 25 25 
25 25 25 25 25 25 25 26 0 0 0 0 0 0 0 0 0 0 0 0 0 0 0 0 0 0 0 0 0 0 24 25 25 25 106 6 0 0 0 0 0 0 0 0 0 30 0 69 0 0 0 0 0 0 30 0 0 0 0 24 25 25 25 25 
25 25 25 25 25 25 25 26 0 0 0 0 0 0 0 0 0 0 0 0 0 0 0 0 0 0 0 0 0 0 24 25 25 25 25 26 0 0 0 0 0 0 0 0 0 30 0 0 0 0 0 0 0 0 30 0 0 0 0 24 25 25 25 25 
25 25 25 25 25 25 25 26 0 0 0 0 0 0 0 0 0 0 0 0 0 94 0 0 0 0 0 0 0 4 107 25 25 25 25 106 6 0 0 0 0 0 0 0 0 30 0 69 0 0 0 0 0 0 30 0 0 0 0 44 87 25 25 25 
25 25 25 25 25 25 25 106 6 0 0 0 0 0 0 0 0 0 0 0 94 0 0 0 0 0 0 0 0 24 25 25 25 25 25 25 106 6 0 0 0 0 0 0 0 30 0 0 0 0 0 0 0 0 30 0 0 0 0 0 24 25 25 25 
25 25 25 25 25 25 25 86 46 0 0 0 0 0 0 0 0 0 0 0 0 0 0 0 0 0 0 0 0 24 25 25 25 25 25 25 25 106 6 0 0 0 0 0 0 51 72 72 72 72 72 72 72 72 53 0 0 0 0 0 24 25 25 25 
25 25 25 25 25 25 25 26 65 65 65 65 65 65 0 0 0 0 0 0 0 0 0 0 0 0 0 0 4 107 25 25 25 25 25 25 25 25 106 5 6 0 0 0 0 0 0 0 0 0 0 0 0 0 0 0 0 0 0 0 24 25 25 25 
25 25 25 25 25 25 25 26 65 63 64 63 64 65 0 0 0 0 0 0 0 0 0 0 0 0 0 0 24 25 25 25 25 142 25 125 25 25 25 25 26 0 0 0 0 0 0 0 0 0 0 0 0 0 0 0 0 0 0 0 24 25 25 25 
25 25 25 25 25 25 86 46 65 83 84 83 84 65 0 0 0 0 0 0 0 0 0 0 0 0 0 0 24 25 25 25 25 25 25 25 25 25 25 25 106 5 5 6 0 0 0 0 0 0 0 0 0 0 0 0 0 0 0 0 24 25 25 25 
25 25 25 25 25 25 26 65 65 103 104 103 104 65 65 0 0 0 0 0 0 0 0 0 0 0 0 0 24 25 25 25 25 25 143 145 25 142 25 25 25 25 25 106 5 5 5 5 5 5 5 5 5 5 5 5 5 5 6 0 24 25 25 25 
25 25 25 25 25 25 26 65 65 0 63 62 65 65 65 65 0 0 0 0 0 0 0 0 0 0 0 0 24 25 25 25 126 25 25 145 25 25 25 25 25 25 25 25 25 25 25 25 25 25 25 25 25 25 25 25 25 25 106 5 107 25 25 25 
25 25 25 25 25 86 46 65 65 65 81 84 65 65 0 65 65 0 0 0 0 0 0 0 0 0 0 0 24 25 25 25 25 25 25 25 25 145 25 25 25 25 86 45 45 45 45 45 45 45 45 87 25 25 25 25 25 25 25 25 25 25 25 25 
25 25 25 25 25 26 65 61 62 65 101 102 0 0 0 65 65 65 0 0 0 0 0 0 0 0 0 0 24 25 25 25 25 25 25 25 25 25 25 25 25 25 26 0 0 0 0 0 0 0 0 44 45 45 45 87 25 25 25 25 25 25 25 25 
25 25 25 25 25 26 65 83 82 65 65 65 65 65 85 85 0 0 0 96 0 0 0 0 0 0 0 0 24 25 25 126 25 25 25 124 124 25 25 86 45 45 46 0 0 0 0 0 0 0 0 0 0 0 0 44 87 25 86 87 25 25 25 25 
25 25 25 25 25 26 65 101 102 0 0 65 65 85 85 0 0 0 94 0 0 0 0 0 0 0 0 0 24 25 25 25 25 125 25 25 25 25 86 46 0 0 0 0 0 0 0 0 0 0 0 0 0 0 0 0 24 25 26 44 87 25 25 25 
25 25 25 25 25 26 63 64 61 62 65 0 85 85 0 0 0 94 0 97 0 65 65 0 0 0 0 0 24 25 25 126 125 25 25 25 25 86 46 0 0 0 0 0 0 0 0 0 0 0 0 0 0 0 0 0 44 45 46 0 24 25 25 25 
25 25 25 25 25 26 83 84 81 84 65 85 85 0 0 0 0 0 96 0 65 65 0 0 0 0 0 0 24 25 25 25 25 25 25 25 86 46 0 0 0 0 0 0 0 0 0 0 0 0 0 0 0 0 0 0 0 0 0 0 24 25 25 25 
25 25 25 25 25 26 103 104 101 102 0 85 85 0 0 0 0 97 0 0 85 85 0 0 0 0 0 0 24 25 25 25 25 25 86 45 46 0 0 0 0 7 8 8 8 8 8 9 0 0 0 0 0 0 0 0 0 0 0 0 24 25 25 25 
25 25 25 25 25 26 0 61 62 65 85 85 0 0 0 0 0 0 0 0 85 85 0 0 0 0 0 0 44 45 45 45 45 45 46 0 0 0 0 0 7 111 7 8 8 8 9 29 0 0 0 7 8 8 8 8 9 0 0 0 24 25 25 25 
25 25 25 25 25 26 0 83 84 65 85 85 0 0 0 0 0 0 0 0 85 85 0 0 0 0 0 0 0 0 0 0 0 0 0 0 0 0 7 8 111 7 111 7 9 28 29 29 0 0 0 27 0 0 0 0 29 0 0 0 24 25 25 25 
25 25 25 25 25 106 6 103 104 85 85 85 0 0 0 0 0 0 0 85 85 85 0 0 0 0 0 0 0 0 0 0 0 0 0 0 0 0 27 28 7 111 28 47 49 28 29 29 0 0 0 27 7 9 0 0 29 0 0 0 24 25 25 25 
25 25 25 25 25 25 26 65 65 85 85 85 85 85 85 85 85 85 85 85 85 85 0 0 0 0 0 0 0 0 0 0 0 0 0 0 0 0 27 28 27 28 28 28 28 90 49 29 0 0 0 27 47 49 0 90 49 0 0 0 24 25 25 25 
25 25 25 25 25 25 26 65 65 65 85 85 85 85 85 85 85 85 85 85 0 0 0 0 0 0 0 0 0 0 0 0 0 0 0 0 0 0 27 28 47 48 48 48 48 49 90 49 0 0 0 47 48 48 91 29 0 0 0 0 24 25 25 25 
25 25 25 25 25 25 106 6 65 65 0 0 0 0 0 0 0 0 0 0 0 0 0 0 0 0 0 0 0 0 0 0 0 0 0 0 0 0 47 48 48 48 48 48 48 48 49 96 97 0 0 0 0 0 47 49 0 4 5 5 107 25 25 25 
25 25 25 25 25 25 25 106 6 0 0 0 0 0 0 0 0 0 0 0 0 0 0 0 0 0 0 0 0 0 0 0 0 0 0 0 0 0 0 0 0 0 0 0 0 0 0 0 97 0 0 0 0 0 0 0 0 24 25 25 25 25 25 25 
25 25 25 25 25 25 25 25 26 0 0 0 0 0 0 127 128 128 128 128 129 0 0 0 0 0 0 0 0 0 0 0 0 0 0 0 0 0 0 0 0 0 0 0 0 0 0 0 0 0 0 0 0 0 0 0 0 24 25 25 25 25 25 25 
25 25 25 25 25 25 25 25 26 0 0 0 0 0 127 151 148 148 148 148 150 129 0 0 0 0 0 0 0 0 0 0 0 0 0 0 0 0 0 0 0 0 0 0 69 0 0 0 0 0 0 0 65 0 0 0 0 24 25 25 25 25 25 25 
25 25 25 25 25 25 25 25 26 0 0 0 0 0 147 148 148 148 148 148 148 150 129 0 0 0 0 0 0 0 0 0 0 0 0 0 0 0 0 0 0 0 0 0 0 0 0 0 0 0 0 0 65 0 0 0 0 24 25 25 25 25 25 25 
25 25 25 25 25 25 25 25 26 0 0 0 0 0 147 148 148 148 148 148 170 168 169 0 0 0 0 0 0 0 0 0 0 4 6 0 0 0 0 0 0 69 0 0 0 0 0 0 0 0 0 0 0 0 0 0 0 24 25 25 25 25 25 25 
25 25 25 25 25 25 25 25 26 0 0 0 0 0 167 131 148 148 148 170 169 0 0 0 0 0 0 0 0 0 0 0 4 107 106 6 0 0 0 0 0 0 0 0 65 0 0 0 0 0 0 0 0 0 0 0 0 24 25 25 25 25 25 25 
25 25 25 25 25 25 25 25 106 6 0 0 0 0 0 167 168 168 168 169 0 0 0 0 0 0 0 0 0 0 0 4 107 25 25 26 0 0 0 0 0 0 0 0 0 0 0 0 0 0 0 0 0 0 0 0 0 24 25 25 25 25 25 25 
25 25 25 25 25 25 25 25 25 106 5 6 0 0 0 0 0 0 0 0 0 0 0 0 0 0 0 0 0 4 5 107 25 25 25 106 5 5 5 5 5 5 5 5 5 5 5 5 5 5 5 5 5 5 5 5 5 107 25 25 25 25 25 25 
25 25 25 25 25 25 25 25 25 25 25 106 5 5 5 5 5 5 5 5 5 5 5 5 5 5 5 5 5 107 25 25 25 25 25 25 25 25 25 25 25 25 25 25 25 25 25 25 25 25 25 25 25 25 25 25 25 25 25 25 25 25 25 25 
25 25 25 25 25 25 25 25 25 25 25 25 25 25 25 25 25 25 25 25 25 25 25 25 25 25 25 25 25 25 25 25 25 25 25 25 25 25 25 25 25 25 25 25 25 25 25 25 25 25 25 25 25 25 25 25 25 25 25 25 25 25 25 25 
25 25 25 25 25 25 25 25 25 25 25 25 25 25 25 25 25 25 25 25 25 25 25 25 25 25 25 25 25 25 25 25 25 25 25 25 25 25 25 25 25 25 25 25 25 25 25 25 25 25 25 25 25 25 25 25 25 25 25 25 25 25 25 25 
25 25 25 25 25 25 25 25 25 25 25 25 25 25 25 25 25 25 25 25 25 25 25 25 25 25 25 25 25 25 25 25 25 25 25 25 25 25 25 25 25 25 25 25 25 25 25 25 25 25 25 25 25 25 25 25 25 25 25 25 25 25 25 25 
25 25 25 25 25 25 25 25 25 25 25 25 25 25 25 25 25 25 25 25 25 25 25 25 25 25 25 25 25 25 25 25 25 25 25 25 25 25 25 25 25 25 25 25 25 25 25 25 25 25 25 25 25 25 25 25 25 25 25 25 25 25 25 25 
25 25 25 25 25 25 25 25 25 25 25 25 25 25 25 25 25 25 25 25 25 25 25 25 25 25 25 25 25 25 25 25 25 25 25 25 25 25 25 25 25 25 25 25 25 25 25 25 25 25 25 25 25 25 25 25 25 25 25 25 25 25 25 25 
25 25 25 25 25 25 25 25 25 25 25 25 25 25 25 25 25 25 25 25 25 25 25 25 25 25 25 25 25 25 25 25 25 25 25 25 25 25 25 25 25 25 25 25 25 25 25 25 25 25 25 25 25 25 25 25 25 25 25 25 25 25 25 25 
25 25 25 25 25 25 25 25 25 25 25 25 25 25 25 25 25 25 25 25 25 25 25 25 25 25 25 25 25 25 25 25 25 25 25 25 25 25 25 25 25 25 25 25 25 25 25 25 25 25 25 25 25 25 25 25 25 25 25 25 25 25 25 25