67 67 67 67 67 67 25 67 25 25 25 25 25 67 25 25 25 25 25 25 25 25 25 67 25 25 25 25 67 25 25 25 25 25 25 25 25 25 25 25 67 67 25 25 25 25 25 25 25 25 25 25 25 25 25 25 25 25 25 25 25 25 25 67 
67 67 25 67 25 25 25 67 25 25 67 25 25 25 25 67 67 25 25 25 67 67 25 25 67 25 25 25 25 67 67 67 67 67 67 67 67 25 25 25 25 67 67 25 25 25 25 25 25 67 67 67 25 67 67 67 67 67 25 25 67 25 25 67 
25 25 67 25 25 25 25 25 25 25 25 67 25 25 25 25 67 67 25 25 25 25 25 25 25 25 25 67 67 67 67 67 25 25 25 25 25 25 25 25 25 25 67 67 67 67 67 25 25 25 25 67 25 25 25 25 25 67 25 67 67 25 67 25 
25 25 25 25 67 25 25 25 25 25 25 25 25 25 25 25 25 25 25 25 25 25 25 25 22 22 22 22 22 22 22 22 22 22 22 22 22 25 25 25 25 25 25 67 25 25 25 25 25 25 25 25 25 25 25 25 25 25 25 25 25 25 67 25 
25 25 25 25 25 25 25 25 25 25 25 25 25 25 25 25 25 25 25 25 25 25 22 22 22 22 55 22 22 22 22 76 22 22 22 22 22 22 22 25 25 25 25 25 25 25 25 25 25 25 25 25 25 25 25 25 25 25 25 25 25 25 67 25 
25 25 25 67 25 25 25 25 25 25 25 25 25 25 25 25 25 25 25 25 25 22 88 42 89 55 22 22 22 22 22 22 22 22 22 22 22 22 22 22 22 22 22 22 22 22 22 22 22 22 22 22 22 22 22 22 22 22 22 22 25 25 25 25 
25 25 25 25 25 25 25 22 22 22 22 22 22 22 22 22 22 22 22 22 22 22 23 66 41 89 22 22 54 22 22 22 76 22 22 37 22 22 22 22 22 22 22 22 22 14 22 22 22 22 22 14 22 22 22 22 22 22 22 22 22 25 25 67 
25 25 25 25 25 25 25 22 22 22 22 22 22 22 22 22 22 22 22 22 22 22 23 66 66 21 22 22 22 22 22 22 22 37 22 22 22 22 35 22 22 22 22 22 22 22 22 14 22 22 22 22 22 22 22 14 22 22 22 22 22 25 25 67 
25 25 25 25 67 25 25 22 22 22 22 22 22 22 22 22 22 22 57 22 22 22 23 66 66 21 22 34 22 22 22 22 22 15 22 22 22 22 22 22 22 22 22 22 22 22 22 22 22 22 88 42 42 42 42 89 22 14 22 22 22 25 67 25 
25 25 25 25 25 25 25 22 22 22 17 22 22 22 22 22 22 22 22 22 22 22 108 3 66 21 22 22 22 22 22 22 22 22 22 22 22 77 22 22 22 22 22 57 22 22 22 88 42 42 43 66 66 66 66 21 22 22 22 22 22 25 67 25 
25 25 25 67 67 25 25 25 25 22 17 22 22 22 16 22 16 22 22 57 22 22 75 23 66 21 22 22 16 22 74 22 54 22 22 36 22 22 22 77 22 22 22 22 22 22 22 108 3 66 66 66 66 66 1 109 22 22 22 22 22 25 25 25 
25 25 25 25 25 25 25 25 25 22 22 17 22 22 22 22 22 22 22 22 22 22 88 43 66 41 89 22 22 22 22 22 22 22 22 22 22 22 57 22 22 22 22 22 22 22 22 88 43 66 66 66 66 66 41 42 89 22 14 22 22 25 25 25 
25 25 25 25 67 25 25 25 25 22 22 22 22 22 22 22 75 22 22 22 57 22 23 66 66 66 41 89 22 22 22 22 22 22 56 22 22 54 22 22 77 22 22 22 22 22 22 108 2 2 3 66 66 66 66 66 21 22 22 22 14 25 25 25 
25 25 67 25 25 25 25 22 22 22 22 22 16 22 22 22 22 22 22 22 22 88 43 66 1 3 66 41 89 16 22 22 56 22 22 22 22 22 22 22 22 22 37 22 22 88 42 42 42 42 43 66 66 66 66 66 21 22 22 22 22 25 25 67 
25 25 67 25 25 25 25 22 22 22 22 17 22 22 22 22 22 22 22 22 88 43 66 1 109 108 3 66 41 89 22 22 22 56 22 22 22 16 22 22 22 22 22 22 22 23 66 66 66 66 66 1 2 2 2 2 109 22 22 22 22 25 67 25 
25 25 25 67 25 25 25 22 22 22 16 22 22 22 17 22 22 22 22 88 43 66 1 109 22 22 108 3 66 41 89 22 22 22 22 16 22 22 22 22 54 22 22 22 22 108 2 2 2 2 3 41 42 42 89 22 22 14 22 22 25 25 25 25 
25 25 25 25 25 25 25 22 22 22 22 22 22 16 22 22 22 22 88 43 66 1 109 22 22 22 22 108 3 66 21 22 22 16 22 22 22 22 54 22 22 22 22 22 88 42 42 42 42 42 43 1 2 2 109 22 22 22 14 22 25 25 25 25 
25 25 25 25 25 25 25 22 22 22 22 17 22 22 22 22 22 88 43 66 1 109 22 22 16 22 22 22 23 66 21 22 22 22 22 22 17 22 22 22 22 88 42 42 43 66 66 66 66 66 66 41 42 42 42 89 22 22 22 22 25 25 25 25 
25 25 25 67 25 25 25 25 22 22 22 16 22 17 22 16 22 23 66 1 109 22 17 17 22 16 22 88 43 66 41 42 42 42 42 42 89 54 22 88 42 43 66 66 66 66 66 66 66 66 66 66 66 66 66 41 89 22 22 22 25 25 25 67 
25 25 25 25 25 25 25 25 22 22 22 22 22 22 22 17 17 108 2 109 17 22 22 16 17 22 88 43 66 1 2 2 2 2 2 2 109 22 22 23 66 66 66 1 3 66 66 66 66 66 66 66 66 66 66 66 21 22 22 22 25 25 67 25 
25 25 25 25 25 25 25 25 22 22 22 22 22 22 22 22 16 22 17 22 16 22 22 22 22 88 43 66 1 109 22 25 25 22 75 22 22 22 55 108 2 2 2 109 108 3 66 66 66 66 66 66 66 66 66 1 109 22 14 25 25 25 25 25 
25 25 67 67 25 25 25 25 22 22 22 22 14 22 22 22 22 22 22 22 22 22 22 22 88 43 66 1 109 22 22 25 25 22 22 22 75 22 22 55 22 22 22 22 22 108 2 3 66 66 66 66 66 66 66 21 22 22 22 25 25 25 67 25 
25 67 25 25 25 25 25 25 22 14 22 22 22 22 22 22 22 22 22 22 22 22 22 88 43 66 1 109 22 22 22 25 25 25 22 22 22 22 22 22 22 22 22 22 22 22 22 108 3 66 66 66 1 2 2 109 22 14 22 25 25 67 25 25 
25 25 25 25 25 25 25 25 22 22 22 22 22 22 22 22 22 22 22 22 22 22 88 43 66 1 109 22 22 22 22 25 25 25 22 22 22 22 22 22 16 22 22 16 22 22 22 88 43 66 66 66 41 89 22 22 22 22 22 25 25 25 67 25 
25 67 25 25 67 25 25 25 22 22 22 22 15 16 76 22 22 22 22 22 88 42 43 66 1 109 22 22 22 22 25 25 25 25 25 22 22 22 22 22 22 22 22 22 22 22 22 23 66 66 66 66 66 21 22 22 17 22 22 25 25 25 67 25 
25 25 25 25 25 25 25 25 22 14 22 22 35 76 37 22 22 22 22 22 23 66 66 1 109 22 22 22 22 22 25 25 25 25 25 25 22 22 22 77 22 22 22 22 22 22 22 108 2 2 3 66 66 21 22 22 22 22 22 25 25 25 25 25 
25 25 25 25 25 25 25 25 22 22 22 22 76 76 57 22 22 22 22 88 43 66 1 109 22 22 22 22 22 22 25 25 67 25 25 25 22 22 22 22 22 22 22 22 22 22 22 88 42 42 43 1 2 109 22 22 22 22 22 25 25 25 67 25 
25 25 25 67 25 67 25 25 22 22 22 22 76 22 22 22 22 22 88 43 66 66 41 42 89 22 22 22 22 25 25 25 25 25 25 25 25 22 22 22 22 22 22 22 22 22 88 43 66 66 1 109 22 88 42 89 17 22 22 25 25 25 25 25 
25 25 25 25 25 25 25 25 25 22 14 76 22 22 22 22 22 88 43 66 66 1 3 66 41 89 22 22 22 25 25 67 25 25 25 25 25 25 22 22 22 22 77 22 22 17 23 66 66 66 21 88 42 43 66 21 22 22 22 22 25 67 67 25 
25 25 67 25 67 25 25 25 25 22 22 22 22 22 22 22 22 23 66 66 1 109 23 66 66 21 22 22 22 25 25 25 25 67 25 25 25 25 25 22 22 22 22 22 22 22 108 3 66 66 41 43 66 66 1 109 22 22 14 22 25 25 25 25 
25 25 25 25 25 25 25 25 22 22 22 22 22 22 22 22 22 108 2 2 109 22 23 66 66 21 22 22 25 25 67 25 25 25 25 25 67 25 25 25 25 22 22 76 22 22 22 23 66 66 66 66 66 1 109 22 15 22 17 22 25 25 25 25 
25 67 67 25 67 25 25 25 22 22 14 22 22 22 75 22 22 22 88 42 42 42 43 66 66 21 22 22 25 25 25 25 25 67 25 25 25 25 25 25 25 22 22 22 22 22 22 108 3 66 66 66 66 21 22 15 22 22 22 22 25 25 25 25 
25 25 25 67 25 25 25 25 22 22 22 22 22 22 22 22 22 88 43 66 66 66 66 66 66 41 89 22 25 25 67 25 67 25 25 25 67 67 25 25 25 25 25 25 22 22 22 88 43 66 66 66 66 21 22 22 22 17 22 22 25 25 25 25 
25 67 25 25 25 25 25 22 22 22 22 22 55 22 22 14 22 23 66 66 66 66 66 66 66 66 21 22 25 25 25 25 25 25 67 25 25 67 67 25 25 25 25 25 25 25 25 25 25 25 25 25 25 25 25 25 25 25 25 22 25 25 67 25 
25 67 25 67 25 25 25 22 22 55 22 22 22 22 22 22 22 23 66 66 66 66 66 66 66 1 109 22 25 25 25 25 25 25 25 25 25 25 25 25 25 25 25 25 25 25 25 25 25 25 25 25 25 25 25 25 25 25 25 25 25 25 25 25 
25 25 25 25 67 25 25 22 22 22 22 22 22 28 34 22 22 23 66 66 66 66 66 66 66 21 22 22 25 25 25 25 25 25 67 25 25 25 25 25 25 25 25 25 25 25 25 25 25 25 25 25 25 25 25 25 25 25 67 25 25 67 25 25 
25 67 25 67 67 25 22 22 22 22 22 22 75 34 34 22 22 23 66 66 66 66 66 66 66 21 22 22 25 25 25 25 25 25 25 25 25 25 25 25 25 25 25 22 22 22 22 22 22 22 22 25 25 25 25 25 25 25 25 67 25 25 25 25 
25 67 25 25 25 25 22 22 22 22 22 22 22 22 22 22 88 43 66 66 66 66 66 66 1 109 17 22 25 25 25 25 25 25 25 25 25 25 25 25 25 25 25 22 22 88 42 42 42 42 42 42 42 42 89 25 25 25 22 25 25 67 25 25 
25 25 67 25 25 25 22 22 22 22 34 22 22 22 22 88 43 66 66 66 66 66 66 66 21 22 17 22 25 25 25 25 25 25 25 25 25 25 25 25 22 16 22 22 22 23 66 66 66 66 66 66 66 66 21 22 25 25 22 25 25 25 67 25 
25 25 67 25 25 25 22 22 22 22 22 55 22 22 88 43 66 66 66 66 66 66 1 2 109 22 22 22 25 25 25 25 25 25 25 25 25 25 25 22 22 22 22 22 22 23 66 66 66 66 66 66 66 66 41 89 25 25 22 22 25 25 25 25 
25 25 67 25 25 25 22 22 22 22 22 22 22 22 23 66 66 66 66 66 66 1 109 22 22 22 22 22 25 25 25 25 25 25 25 25 25 25 22 22 22 22 22 22 22 108 2 2 3 66 1 2 3 1 2 109 22 22 22 22 25 25 25 25 
25 25 25 67 25 25 22 22 22 22 34 22 22 22 108 3 66 66 66 66 1 109 22 22 22 17 22 22 25 25 25 25 25 25 25 25 25 22 22 75 22 22 22 75 22 88 42 42 43 66 21 88 43 41 42 42 89 14 22 22 25 25 67 25 
25 67 25 67 25 25 22 22 22 22 22 22 22 88 42 43 66 66 66 66 21 22 22 22 22 22 22 22 25 25 25 25 25 25 25 22 22 22 22 22 22 15 28 28 28 28 28 66 66 66 21 108 2 2 2 2 109 16 22 22 25 67 25 67 
25 67 25 67 25 25 22 22 22 22 22 22 22 23 66 66 66 66 66 66 21 22 22 17 22 17 22 22 22 22 22 22 22 22 22 22 22 22 88 42 42 28 28 28 28 28 28 66 66 66 21 22 28 15 28 28 22 22 22 22 25 25 67 67 
25 67 25 67 25 25 25 22 22 22 22 22 88 43 66 66 66 66 1 2 109 22 22 22 22 22 22 55 22 17 22 22 22 55 22 22 17 88 43 28 28 28 28 28 28 66 28 66 66 66 21 22 28 28 28 55 22 57 57 22 25 25 67 25 
25 67 25 25 25 25 25 22 22 22 22 22 23 66 66 66 66 66 21 22 22 22 17 22 22 22 22 22 22 22 22 22 22 22 22 22 88 43 66 28 28 28 28 28 28 28 28 66 66 66 41 42 28 28 28 22 22 22 22 22 25 25 25 67 
25 25 67 25 25 25 25 22 22 22 22 22 23 66 66 66 66 66 21 17 22 22 22 22 22 22 22 22 22 22 55 22 22 88 42 42 43 66 66 28 28 28 28 28 28 28 66 66 66 66 1 2 3 41 42 42 89 22 22 22 25 25 67 25 
25 25 67 25 25 25 25 25 22 22 22 22 108 2 2 2 2 2 109 22 22 22 22 22 22 17 22 22 22 22 88 42 42 43 66 66 66 66 66 66 66 66 66 66 66 66 66 66 66 66 41 42 43 66 66 1 109 25 25 25 25 67 67 25 
25 25 25 67 25 25 25 25 25 22 22 22 22 22 22 22 17 22 22 22 22 17 22 22 22 22 22 17 22 88 43 66 66 66 66 1 2 2 2 2 2 2 2 2 2 3 66 66 66 66 66 1 2 2 2 109 22 25 25 25 25 25 25 25 
25 25 25 67 25 25 25 25 25 22 22 22 17 22 22 22 22 22 17 22 22 22 22 22 22 17 22 88 42 43 66 1 2 2 2 109 17 22 22 56 22 22 22 22 55 108 3 66 66 66 66 41 89 22 14 22 22 25 25 25 25 25 67 25 
25 25 25 25 67 25 25 25 25 22 22 22 22 22 22 22 22 57 22 22 22 22 57 22 22 22 22 23 1 2 2 109 22 22 22 22 22 22 54 22 22 22 54 22 22 22 108 2 2 3 66 66 41 89 14 22 22 25 25 25 25 67 67 25 
25 25 25 67 25 25 25 25 25 22 22 22 22 22 22 22 22 22 22 22 22 22 22 57 22 22 22 108 109 22 22 22 55 22 22 22 22 54 28 28 28 28 28 28 28 55 28 88 42 43 66 66 66 41 89 22 22 25 25 25 67 25 25 25 
25 25 67 25 67 25 25 25 25 22 22 22 17 22 22 57 22 22 17 22 22 22 22 22 22 22 22 22 22 22 22 22 22 25 25 22 22 22 22 22 54 22 22 56 22 22 22 108 3 66 66 66 66 66 21 22 22 25 25 25 25 25 25 25 
25 25 67 25 67 25 25 25 25 22 22 22 22 22 22 22 22 22 22 22 22 22 22 22 17 22 22 22 17 22 22 22 25 25 25 25 22 22 22 22 22 22 22 22 22 22 22 88 43 66 1 2 2 2 109 22 22 25 25 25 25 67 25 25 
25 67 67 25 67 67 25 25 25 25 22 22 22 22 17 22 22 22 22 22 22 22 22 22 22 22 22 22 22 22 22 25 25 25 25 25 22 22 22 22 22 22 22 22 22 22 22 108 2 2 109 22 22 22 22 22 22 25 25 25 25 67 25 25 
25 25 25 25 25 67 25 25 25 25 25 25 22 22 22 22 22 22 22 22 22 22 22 22 22 22 22 22 22 25 25 25 25 25 25 25 25 25 25 25 25 25 25 25 25 25 25 25 25 25 25 25 25 25 25 25 25 25 25 25 67 25 25 25 
25 25 67 25 25 67 67 25 25 25 25 25 25 25 25 25 25 25 25 25 25 25 25 25 25 25 25 25 25 25 25 25 25 25 25 25 25 25 25 25 25 25 25 25 25 25 25 25 25 25 25 25 25 25 25 25 25 25 67 67 25 25 25 25 
25 67 67 25 25 25 67 25 25 25 25 25 25 25 25 25 25 25 25 25 25 25 25 25 25 25 25 25 25 25 25 25 25 25 25 25 25 67 67 25 25 67 67 67 25 25 25 25 25 25 25 25 67 67 25 67 25 25 25 25 25 25 25 25 
25 67 67 25 25 25 67 67 25 25 25 25 25 25 25 25 25 25 25 25 25 25 67 25 25 25 67 25 25 25 25 25 67 67 25 67 25 67 25 25 25 25 25 67 25 25 67 67 25 25 25 67 25 25 25 25 25 25 25 25 25 25 25 25 
67 67 25 25 25 25 67 67 25 67 67 25 67 67 67 67 25 25 25 25 67 67 25 67 25 67 67 67 25 25 25 67 67 25 25 25 67 25 67 67 25 25 67 25 25 67 25 67 67 67 67 25 25 25 25 25 25 25 25 25 25 25 25 25 
25 25 25 25 25 25 25 67 67 67 25 25 25 67 25 67 25 25 25 25 67 25 25 25 25 25 25 67 67 25 67 25 25 25 25 25 25 67 67 25 25 25 25 67 25 25 25 25 25 25 25 25 25 25 25 25 25 25 25 25 25 25 25 25 
25 25 25 25 25 25 25 25 25 25 25 25 25 25 25 25 67 67 25 67 25 25 25 25 25 25 25 25 25 25 25 25 25 25 25 25 25 25 25 25 25 25 25 25 25 25 25 25 25 25 25 25 25 25 25 25 25 25 25 25 25 25 25 25 
25 25 25 25 25 25 25 25 25 25 25 25 25 25 25 25 25 25 25 25 25 25 25 25 25 25 25 25 25 25 25 25 25 25 25 25 25 25 25 25 25 25 25 25 25 25 25 25 25 25 25 25 25 25 25 25 25 25 25 25 25 25 25 25 
25 25 25 25 25 25 25 25 25 25 25 25 25 25 25 25 25 25 25 25 25 25 25 25 25 25 25 25 25 25 25 25 25 25 25 25 25 25 25 25 25 25 25 25 25 25 25 25 25 25 25 25 25 25 25 25 25 25 25 25 25 25 25 25