86 45 45 45 45 45 45 45 45 45 45 45 45 45 45 45 45 45 45 45 45 45 45 45 45 45 45 45 45 45 45 45 45 45 45 45 45 45 45 45 45 45 87 218 236 219 25 25 25 25 25 25 26 85 7 8 8 8 8 8 8 8 8 9 
26 0 0 0 0 0 0 0 0 0 0 61 64 0 0 0 0 0 0 0 0 0 0 0 0 0 0 0 0 0 0 0 0 0 0 0 0 0 0 0 0 0 24 217 0 235 219 25 25 25 25 25 26 85 27 7 8 8 8 8 8 8 9 29 
26 0 0 0 0 0 0 0 0 0 0 83 82 0 0 0 0 0 0 0 0 0 0 0 85 85 85 85 85 0 0 0 0 0 0 0 0 0 0 0 0 0 24 217 0 0 235 219 25 25 25 25 26 85 27 27 7 8 8 8 8 9 29 29 
26 0 0 0 0 0 0 0 0 0 65 103 104 65 0 0 0 0 0 0 0 0 0 0 0 0 0 0 0 0 0 0 0 0 0 0 0 0 0 0 0 0 24 217 0 0 0 235 219 25 25 25 26 85 27 27 27 7 8 8 9 29 29 29 
26 0 0 0 0 0 0 0 0 65 65 65 65 65 0 0 0 0 0 0 0 0 0 0 0 0 0 0 0 0 0 0 0 0 0 0 0 0 0 0 0 4 107 217 0 0 0 0 235 219 25 25 26 85 27 27 27 27 85 85 29 29 29 29 
26 0 0 0 0 0 0 0 0 0 63 64 0 65 0 0 0 0 0 0 0 0 0 0 11 72 72 72 13 0 0 0 0 0 0 0 0 0 0 0 0 24 25 238 197 0 0 0 0 215 25 25 26 85 27 27 27 47 91 85 29 29 29 29 
26 0 0 0 0 0 0 0 0 65 83 82 0 0 0 0 0 0 0 0 0 0 0 0 30 4 5 6 30 0 0 0 0 0 0 0 0 0 0 0 0 24 25 25 217 0 0 0 0 215 25 25 26 85 27 27 47 91 47 91 29 29 29 29 
26 0 0 0 0 0 0 0 0 65 103 104 65 0 0 0 0 0 0 0 0 0 11 72 53 24 25 26 30 0 0 0 0 0 0 0 0 0 0 0 4 107 25 25 238 197 0 0 0 235 219 25 106 6 27 47 91 47 91 47 49 29 29 29 
26 0 0 0 0 0 0 0 65 65 65 65 65 0 0 0 0 0 0 0 0 0 30 4 5 107 25 26 30 0 0 0 0 0 0 0 0 0 0 0 24 25 25 25 25 217 0 0 0 0 235 219 25 26 47 91 47 91 47 91 85 29 29 29 
26 0 0 0 0 0 0 0 0 63 64 0 0 65 0 0 0 0 0 0 0 11 53 24 25 25 86 46 30 0 0 0 0 0 0 0 0 0 0 0 24 25 25 25 25 238 197 0 0 0 0 215 25 26 85 47 91 47 91 47 48 49 29 29 
26 0 0 0 0 0 0 0 0 81 84 65 0 0 0 0 0 0 0 0 11 53 4 107 25 86 46 11 53 0 0 0 0 0 0 0 0 0 0 0 24 25 25 25 25 25 238 197 0 0 0 235 219 26 85 85 47 91 47 48 48 48 49 29 
26 0 0 0 0 0 0 0 65 103 104 65 0 0 0 0 0 0 0 11 53 4 107 25 86 46 11 53 0 0 0 0 0 0 0 0 0 0 0 0 24 25 25 25 25 25 25 238 197 0 0 0 215 26 85 85 85 47 48 48 48 91 85 29 
26 0 0 0 0 0 0 0 65 65 65 0 0 0 0 0 0 0 11 53 4 107 25 25 26 11 53 0 0 0 0 0 0 0 0 0 0 0 0 4 107 25 25 25 25 25 25 25 238 196 196 196 239 106 6 85 85 85 85 85 85 47 48 49 
26 0 0 0 0 0 0 0 0 0 0 0 0 0 0 0 0 0 30 4 107 25 25 25 26 30 0 0 0 0 0 0 0 0 0 0 0 0 0 24 25 25 25 25 25 25 25 25 25 25 25 25 25 25 106 5 5 5 5 5 6 85 85 85 
26 0 0 0 0 0 0 0 0 0 0 0 0 0 0 11 72 72 53 24 25 25 25 86 46 30 0 0 0 0 0 0 0 0 0 0 0 0 0 24 25 25 25 25 25 25 25 25 25 25 25 25 25 25 25 25 25 25 25 25 106 5 5 5 
26 0 0 7 8 9 0 0 0 0 0 0 0 0 0 30 4 5 5 107 25 25 25 26 71 33 0 0 0 0 0 0 0 0 0 0 0 0 0 24 25 25 25 25 25 25 25 25 25 25 25 25 25 25 25 25 25 25 25 25 25 25 25 25 
26 0 0 27 28 29 0 0 0 0 0 0 0 0 0 30 24 25 25 25 25 25 25 106 6 30 0 0 0 0 0 0 0 0 0 0 0 0 0 24 25 25 105 25 25 25 25 25 25 25 25 25 25 25 25 25 25 25 25 25 25 25 25 25 
26 0 0 47 48 49 0 0 0 0 0 0 0 0 0 30 24 25 25 25 25 25 25 25 26 30 0 0 0 0 0 0 0 0 0 0 0 0 0 24 25 25 105 105 25 25 25 25 25 25 25 178 179 25 25 25 25 25 25 25 25 25 25 25 
26 0 0 0 0 0 0 0 7 8 9 0 0 0 0 30 24 25 25 25 25 25 25 25 26 30 0 0 0 0 0 0 0 65 65 0 0 0 4 107 25 25 25 105 105 25 25 25 25 25 25 214 212 25 25 25 25 25 25 25 25 25 25 25 
26 0 0 0 0 0 0 0 27 28 29 0 0 0 0 30 44 45 45 45 45 45 45 45 46 30 0 0 0 0 0 0 65 0 65 0 0 0 24 25 25 25 25 25 25 25 25 25 25 25 178 234 212 25 25 25 25 25 25 25 25 25 25 25 
26 0 0 7 8 9 0 0 47 48 49 0 0 0 0 51 52 72 72 72 72 72 72 72 72 72 72 72 73 0 0 0 0 0 0 0 0 0 24 25 25 25 25 25 25 25 25 25 25 25 214 0 212 25 25 25 25 25 25 25 25 25 25 25 
26 0 0 27 28 29 0 0 0 0 0 0 0 0 0 0 0 0 0 0 0 0 0 0 0 0 0 0 0 0 0 0 0 0 0 0 0 0 24 25 25 178 233 233 179 25 25 25 25 25 214 0 212 25 25 25 25 25 25 25 25 25 25 25 
26 0 0 47 48 49 0 0 0 0 0 0 0 0 0 0 0 0 0 0 0 0 0 0 0 0 0 0 0 0 0 65 0 0 0 0 0 0 24 25 25 214 0 0 232 179 25 25 178 233 234 0 212 25 25 25 25 25 25 25 25 25 25 25 
26 0 0 0 0 0 0 0 7 8 9 0 0 0 0 0 0 0 0 0 0 0 0 0 0 0 0 0 0 65 0 65 0 0 0 0 0 0 24 25 25 214 0 0 0 232 179 25 214 0 0 0 212 25 25 25 25 25 25 25 25 25 25 25 
26 0 0 0 0 0 0 0 27 28 29 0 0 0 0 0 0 0 0 0 0 0 0 0 0 0 0 0 65 65 0 0 0 0 0 0 0 0 24 25 25 214 0 0 0 0 232 233 234 0 0 192 199 25 25 25 25 25 25 25 25 25 25 25 
26 0 0 0 0 0 0 0 47 48 49 0 0 0 0 0 0 0 0 0 0 0 0 0 0 0 0 65 0 0 0 0 0 0 0 0 0 0 24 25 25 198 194 0 0 0 0 0 0 0 192 199 25 25 25 25 25 25 25 25 25 25 25 25 
26 0 0 0 0 0 0 0 0 0 0 0 0 0 0 0 0 0 0 0 0 0 0 0 0 0 0 65 0 0 0 0 0 0 0 0 0 4 107 25 25 25 214 0 0 0 0 0 0 0 212 25 25 25 25 25 25 25 25 25 25 25 25 25 
26 0 0 0 0 0 0 0 0 0 0 0 0 0 0 0 0 0 0 0 0 0 0 0 0 0 65 0 0 0 0 0 0 0 0 0 0 24 25 25 25 25 198 193 194 0 0 0 0 0 212 25 25 25 25 25 25 25 25 25 25 25 25 25 
26 0 0 0 0 0 0 0 0 0 0 114 115 116 0 0 0 0 0 0 0 0 0 0 0 0 0 0 0 0 0 0 0 0 0 0 0 24 25 25 25 25 25 25 214 0 0 0 0 192 199 25 25 25 25 25 25 25 25 25 25 25 25 25 
26 0 0 0 0 0 0 0 0 0 0 0 0 0 0 0 0 0 0 0 0 0 0 0 0 0 0 0 0 0 0 0 0 0 0 0 0 24 25 25 25 25 25 25 214 0 0 0 0 232 179 25 25 25 25 25 25 25 25 25 25 25 25 25 
26 0 0 0 0 0 0 114 115 116 0 0 0 0 0 0 0 0 0 0 0 0 0 0 0 0 0 0 0 0 0 0 0 0 0 0 4 107 25 25 25 25 25 178 234 0 0 0 0 0 232 179 25 25 25 178 233 233 233 179 25 25 25 25 
26 0 0 0 0 0 0 0 0 0 0 0 0 0 0 0 0 0 85 0 85 0 85 0 0 0 0 0 0 0 0 0 0 0 0 0 24 25 25 25 25 25 25 214 0 0 0 0 0 0 0 232 233 233 233 234 0 0 0 232 233 233 179 25 
26 0 0 0 127 128 128 128 128 128 129 0 0 0 0 0 0 0 0 0 0 85 85 85 0 85 0 85 0 85 85 0 0 0 0 0 24 25 25 25 25 25 178 234 0 0 192 193 194 0 0 0 0 0 0 0 0 0 0 0 0 0 212 25 
26 0 0 127 151 148 130 168 168 168 150 128 128 128 128 129 0 0 0 0 114 115 116 0 0 0 0 0 0 0 85 85 0 0 0 4 107 178 233 179 25 178 234 0 0 0 212 25 214 0 0 0 0 0 0 0 0 0 0 0 0 0 212 25 
26 0 0 147 148 130 169 0 0 0 167 131 148 148 148 149 0 0 0 0 0 0 0 0 0 0 0 0 0 0 0 85 0 0 0 232 233 234 0 232 233 234 0 0 0 192 199 25 198 193 193 193 193 193 193 193 193 193 193 193 193 193 199 25 
26 0 0 147 148 149 0 0 0 0 0 147 148 148 148 149 0 0 0 0 0 0 114 115 116 0 0 0 0 0 0 0 0 0 0 0 0 0 0 0 0 0 0 0 192 199 25 25 25 25 25 25 25 25 25 25 25 25 25 25 25 25 25 25 
26 0 0 167 131 150 129 0 0 0 0 147 148 148 148 149 0 0 0 0 0 0 0 0 0 0 0 0 0 0 0 0 0 0 0 0 114 115 116 0 0 0 0 0 212 25 25 25 25 25 25 25 25 25 25 25 25 25 25 25 25 25 25 25 
26 0 0 0 147 148 149 0 0 0 0 147 148 148 148 149 0 0 0 0 0 0 0 0 0 0 0 0 0 0 0 0 0 4 5 5 114 115 116 0 0 0 0 192 199 25 25 25 25 25 25 25 25 25 25 25 25 25 25 25 25 25 25 25 
26 0 0 0 167 131 150 129 0 0 127 151 148 148 148 149 0 0 0 0 0 0 0 0 0 0 0 0 0 0 4 5 5 107 25 25 106 107 214 0 0 0 192 199 25 25 25 25 25 25 25 25 25 25 25 25 25 25 25 86 45 45 45 87 
26 0 0 0 0 167 168 169 0 0 167 168 168 168 168 169 0 0 0 0 0 0 0 0 0 0 0 0 4 5 107 25 25 25 25 25 25 25 214 0 192 193 199 25 25 25 25 25 25 25 25 25 25 25 25 25 25 86 45 46 0 0 0 24 
26 0 0 0 0 0 0 0 0 0 0 0 0 0 0 0 0 0 0 0 0 0 0 0 0 4 5 5 107 25 25 25 25 25 25 25 25 178 234 0 232 179 25 25 25 25 25 25 25 25 25 25 25 25 25 25 86 46 0 0 0 0 0 24 
26 0 0 0 0 0 0 0 0 0 0 0 0 0 0 0 0 0 0 0 4 5 5 5 5 107 25 25 25 25 25 25 25 25 25 25 25 198 194 0 0 212 25 25 25 25 25 25 25 25 25 25 25 25 86 45 46 0 0 0 0 0 0 24 
106 5 5 5 5 5 5 5 5 5 5 5 5 5 5 5 5 5 5 5 107 25 25 25 25 25 25 25 25 25 25 25 25 25 25 25 25 178 234 0 0 212 25 25 25 25 25 25 25 25 25 25 25 86 46 0 0 0 0 0 65 0 0 24 
25 25 25 25 25 25 25 25 25 25 25 25 25 25 25 25 25 25 25 25 25 25 25 25 25 25 25 25 25 25 25 25 25 25 25 25 25 214 0 0 0 232 179 25 25 25 25 25 25 25 25 25 86 46 0 0 0 0 0 0 0 0 0 24 
25 25 25 25 25 25 25 25 25 25 25 25 25 25 25 25 25 25 25 25 25 25 25 25 25 25 25 25 25 25 25 25 67 25 25 25 25 198 193 194 0 0 232 179 25 25 25 25 25 25 25 86 46 0 0 0 0 0 0 0 0 0 0 24 
25 25 25 25 25 25 25 25 25 25 25 25 25 25 25 25 25 25 25 25 25 25 25 25 25 67 25 25 141 25 25 25 25 25 25 25 25 25 25 214 0 0 0 232 179 25 25 25 86 45 45 46 0 0 0 0 0 0 0 0 0 0 0 24 
25 25 25 25 25 25 25 25 25 25 25 25 25 25 25 25 25 25 25 25 25 25 25 25 25 25 144 25 25 25 142 25 25 25 146 25 67 25 25 198 194 0 0 0 232 179 25 86 46 0 0 0 0 0 0 0 0 0 0 0 0 0 0 24 
25 25 25 25 25 25 25 25 25 25 25 25 25 25 25 124 25 125 25 25 25 25 25 25 144 25 25 25 25 25 25 25 25 25 25 25 25 25 25 25 214 0 0 0 0 232 45 46 0 0 0 0 0 0 0 0 0 0 0 0 0 0 0 24 
25 25 25 25 25 25 25 25 25 124 25 25 124 122 25 25 25 124 25 25 25 25 25 25 25 25 67 25 25 25 25 67 25 25 25 25 25 25 25 25 198 193 194 0 0 114 115 116 0 0 0 0 0 85 0 0 0 0 0 0 0 0 0 24 
25 25 25 25 25 121 25 25 25 25 25 25 25 25 124 25 25 121 126 25 25 25 25 25 25 25 25 25 25 25 25 25 25 25 25 25 25 25 25 25 25 25 234 0 0 0 0 0 0 0 0 0 0 0 114 115 115 115 115 116 0 0 0 24 
25 25 25 25 25 25 25 25 25 25 121 25 25 25 25 25 25 25 25 25 25 25 25 25 25 25 25 25 25 25 25 25 25 25 25 86 45 45 45 114 115 116 0 0 0 0 0 0 0 0 0 0 0 85 0 0 0 0 0 0 0 0 0 24 
25 25 25 25 25 25 25 25 25 25 25 25 25 25 25 25 25 25 67 25 25 25 67 25 25 25 25 25 25 25 86 45 45 45 45 46 0 0 0 0 0 0 0 0 0 0 0 0 0 0 0 0 0 0 0 0 0 7 8 8 8 8 9 24 
86 45 45 45 87 25 25 25 25 25 25 25 25 25 25 25 25 25 25 25 25 25 25 25 25 86 45 45 45 45 46 0 0 0 0 0 0 0 0 0 0 0 0 0 0 0 0 0 0 0 0 0 0 0 0 7 8 111 69 69 69 69 29 24 
26 0 0 0 44 45 45 45 87 25 25 25 25 25 25 25 25 25 25 25 86 45 45 45 45 46 0 0 0 0 0 0 0 0 0 0 0 0 0 0 0 0 0 0 0 0 0 0 0 0 0 0 0 0 7 111 69 69 69 69 69 69 29 24 
26 0 0 0 0 0 0 0 44 45 45 45 45 45 45 45 45 45 45 45 46 0 0 0 0 0 0 0 0 0 0 0 0 0 0 0 0 0 0 0 0 0 0 0 0 0 0 0 0 0 0 0 7 8 111 7 8 8 8 8 8 9 29 24 
26 0 0 0 0 0 0 0 0 0 0 0 0 0 0 0 0 0 0 0 0 0 0 0 0 0 0 0 0 0 0 0 0 0 0 0 85 0 0 0 0 0 0 0 0 0 0 0 0 0 0 0 27 69 69 27 69 69 61 62 69 29 29 24 
26 0 0 0 0 0 0 0 0 0 0 0 0 0 0 0 0 0 0 0 0 0 0 0 0 0 0 0 0 0 0 0 0 0 85 85 85 85 0 0 0 0 0 0 0 0 0 0 0 0 0 0 27 69 69 27 69 69 81 82 69 29 29 24 
26 0 65 0 65 65 65 65 65 65 65 65 0 0 0 0 0 0 0 0 0 0 0 0 0 0 0 0 65 0 0 0 0 0 85 0 0 0 0 0 0 0 0 0 0 0 0 0 0 0 0 7 111 69 69 27 61 62 101 102 69 29 29 24 
26 0 0 0 65 65 65 0 0 0 0 65 0 0 0 0 0 0 0 0 0 0 0 0 0 0 0 0 65 85 85 0 0 0 85 0 0 0 0 0 0 0 0 0 0 0 0 0 0 0 0 27 69 69 0 27 81 82 69 69 69 29 29 24 
26 0 65 0 65 65 0 0 0 0 0 65 0 0 0 0 0 0 0 0 0 0 0 0 0 65 65 65 85 85 85 85 0 0 85 0 0 0 0 0 0 0 0 0 0 0 0 0 0 69 0 47 91 69 69 27 101 102 69 69 69 29 29 24 
26 0 0 0 0 0 0 69 0 0 0 65 0 0 0 0 0 0 0 0 0 0 0 0 0 0 114 115 116 69 85 85 85 0 85 0 0 0 0 0 0 0 0 0 0 0 0 0 0 0 0 0 47 91 69 47 48 48 48 48 48 49 29 24 
26 0 0 0 0 0 0 0 0 0 0 65 0 0 0 0 0 0 0 0 0 0 0 0 0 0 0 0 85 85 85 0 85 85 0 0 0 0 0 0 0 0 0 0 0 0 0 0 0 0 0 0 0 47 91 69 69 69 69 69 69 69 29 24 
26 0 0 0 0 0 0 0 0 0 0 65 0 0 0 0 0 0 0 0 0 0 0 0 0 0 0 0 0 0 0 0 0 0 0 0 0 0 0 0 0 0 0 0 0 0 0 0 0 0 0 0 0 0 47 48 48 48 48 48 48 48 49 24 
106 5 5 5 5 5 5 5 5 5 5 5 5 5 5 5 5 5 5 5 5 5 5 5 5 5 5 5 5 5 5 5 5 5 5 5 5 5 5 5 5 5 5 5 5 5 5 5 5 5 5 5 5 5 5 5 5 5 5 5 5 5 5 107
