0 0 0 0 0 0 0 0 0 0 0 0 0 0 0 0 0 0 0 0 0 0 0 0 0 0 0 0 0 0 0 0 0 0 0 0 0 0 0 0 0 0 0 25 25 67 25 67 25 25 25 25 26 28 66 66 66 66 66 66 66 66 66 66 
0 28 28 28 28 28 28 28 28 28 28 28 28 28 28 28 28 28 28 28 28 28 28 28 28 28 28 28 28 28 28 28 28 28 28 28 28 28 28 28 28 28 0 25 66 25 25 25 25 25 25 25 26 28 66 28 28 28 28 28 28 28 28 66 
0 28 34 28 28 28 28 28 28 28 28 28 28 28 28 28 54 28 28 28 28 28 56 28 28 28 56 28 28 54 28 28 28 28 28 28 17 28 28 28 28 28 0 66 66 66 25 25 25 25 25 25 26 28 66 28 28 28 28 28 28 28 28 66 
0 28 28 28 28 28 28 28 28 28 28 28 28 28 28 28 28 34 28 28 28 28 28 28 28 28 28 28 28 54 28 28 28 17 17 28 28 28 28 28 28 28 0 25 66 66 66 25 25 25 25 25 26 28 66 28 28 28 28 28 28 28 28 66 
0 28 28 28 28 15 28 28 28 54 28 28 28 28 28 28 28 28 28 28 56 28 28 34 28 28 28 28 28 28 28 17 28 28 28 28 28 28 28 54 28 0 0 25 66 66 66 66 25 25 25 25 26 28 66 28 28 28 28 28 28 28 28 66 
0 28 28 28 28 28 28 28 28 28 28 28 28 34 28 28 28 28 17 28 28 28 28 28 28 28 28 28 28 28 28 28 28 28 28 28 28 28 28 28 28 0 25 25 25 66 66 66 66 25 25 25 26 28 66 28 28 28 28 28 28 28 28 66 
0 28 28 28 15 28 28 28 28 28 28 28 28 28 15 28 28 28 28 28 28 28 17 28 28 4 5 6 28 28 28 28 28 54 28 17 28 28 28 28 28 0 25 25 25 66 66 66 66 25 25 25 26 28 66 28 28 28 28 28 28 28 28 66 
0 28 28 28 28 28 28 28 28 15 28 28 28 28 28 28 28 28 28 35 28 28 28 28 28 24 25 26 28 28 28 54 28 28 28 28 28 28 28 28 0 0 25 67 25 25 66 66 66 25 25 25 106 6 66 28 28 28 28 28 28 28 28 66 
0 28 28 28 28 28 28 28 28 28 28 28 56 28 28 56 28 28 28 28 28 28 28 4 5 107 25 26 28 28 28 28 35 28 28 28 28 35 28 28 0 25 25 25 25 25 66 66 66 66 25 25 25 26 66 66 28 28 28 28 28 28 28 66 
0 28 28 28 54 28 15 28 28 28 28 28 28 28 28 28 28 28 28 28 28 28 28 24 25 25 86 46 56 28 28 28 28 28 28 28 28 28 28 28 0 25 25 25 25 25 25 66 66 66 66 25 25 26 28 66 66 28 28 28 28 28 28 66 
0 28 28 28 28 28 28 28 28 28 28 28 28 28 28 28 28 28 28 28 28 28 4 107 67 86 46 28 28 28 28 28 28 28 28 28 28 55 28 28 0 25 25 25 67 25 25 25 66 66 66 25 25 26 28 28 66 66 28 28 28 28 28 66 
0 28 28 28 28 28 28 28 28 15 28 28 35 28 28 28 56 28 28 28 28 4 107 25 86 46 28 28 28 28 55 28 28 28 28 28 55 28 28 28 0 25 25 25 25 25 25 25 25 66 66 66 25 26 28 28 28 66 66 66 66 66 28 66 
0 28 54 28 28 28 28 35 28 28 28 28 28 28 28 28 28 28 28 28 4 107 25 25 26 28 28 28 28 28 55 28 28 28 28 28 28 28 28 0 0 25 25 25 25 25 67 25 25 25 25 25 25 106 6 28 28 28 28 28 28 66 66 66 
0 28 28 28 28 28 28 28 28 28 28 28 35 28 28 28 28 28 28 4 107 25 67 86 46 28 28 28 28 28 28 28 28 28 28 28 28 55 28 0 25 25 25 25 25 25 25 25 25 25 25 25 25 25 106 5 5 5 5 5 6 28 28 28 
0 28 28 28 28 28 28 28 54 28 28 28 28 28 57 28 28 28 28 24 25 25 25 26 28 28 28 55 28 55 28 28 28 36 28 28 28 28 28 0 25 25 67 25 25 25 25 25 25 67 25 25 67 25 25 25 25 25 25 25 106 5 5 5 
0 88 42 42 42 89 28 28 28 28 28 28 28 28 28 28 4 5 5 107 25 25 86 46 28 28 28 28 55 28 28 28 17 28 28 55 28 28 28 0 25 25 25 25 25 25 67 25 25 25 25 25 25 25 25 25 25 25 25 25 25 25 25 25 
0 23 66 66 66 41 42 42 89 28 28 28 28 28 28 28 24 25 25 25 67 25 106 5 6 28 28 28 28 28 28 28 28 28 28 28 28 28 28 0 25 25 25 25 67 25 25 25 25 67 25 25 25 25 25 25 25 25 25 67 25 67 25 25 
0 23 66 66 66 66 66 66 41 89 37 28 28 54 28 28 24 25 67 25 25 25 25 25 26 28 28 28 28 28 28 28 28 28 28 28 28 28 28 0 25 25 25 25 25 25 25 25 25 25 25 25 25 25 25 25 25 67 25 25 25 25 25 25 
0 23 66 66 66 66 66 66 66 41 89 28 28 28 28 28 44 87 25 25 25 25 86 87 26 28 28 36 28 28 28 28 28 28 54 28 28 28 0 0 25 25 25 25 25 25 25 67 25 25 25 25 25 25 25 25 25 25 25 25 25 25 25 67 
0 23 66 66 66 66 66 66 66 66 41 89 28 28 28 28 28 44 45 45 45 45 46 44 46 28 28 28 28 28 28 28 28 28 28 28 28 28 0 25 25 25 67 25 25 67 25 25 25 25 25 25 68 25 25 67 25 67 25 25 25 67 25 25 
0 23 66 66 66 66 66 66 66 66 66 21 28 37 28 54 28 28 28 28 28 28 28 28 28 28 28 28 28 54 28 28 28 28 28 28 28 28 0 25 25 25 25 25 25 25 25 25 25 25 25 68 68 25 25 25 25 25 25 25 25 25 25 25 
0 23 66 66 66 66 66 66 66 66 66 41 89 28 28 28 28 28 28 28 28 28 28 54 28 28 28 54 28 28 28 28 28 54 28 28 28 28 0 25 25 25 25 25 25 25 25 25 25 25 25 68 68 25 25 25 25 25 25 25 25 25 25 25 
0 23 66 66 66 66 66 66 66 66 66 66 41 89 28 28 28 54 28 37 28 28 28 28 28 37 28 28 28 28 28 28 28 28 28 74 28 28 0 25 25 25 68 68 25 25 25 25 25 25 25 68 68 25 25 25 25 25 67 67 67 25 25 25 
0 23 66 66 66 66 66 66 66 66 66 66 66 21 28 28 28 28 28 28 28 28 28 28 28 28 28 28 28 28 28 54 28 28 28 28 28 28 0 25 25 25 68 68 68 25 25 25 25 68 68 68 68 25 25 67 67 67 25 25 25 25 25 25 
0 108 2 3 66 66 66 66 66 66 66 66 66 41 89 28 37 28 28 28 28 15 28 28 28 28 28 28 36 28 28 28 28 28 28 28 28 28 0 25 25 25 68 68 68 68 25 25 25 68 68 25 25 25 25 25 25 25 25 25 67 67 67 25 
0 28 28 108 3 66 66 66 66 66 66 66 66 1 109 28 28 28 28 37 28 28 28 36 28 28 28 28 28 28 28 28 28 28 74 28 28 28 0 25 25 25 25 68 68 68 68 68 68 68 25 25 25 25 25 25 25 25 67 67 67 25 25 25 
0 28 28 28 108 3 66 66 66 66 1 2 2 109 28 88 89 28 28 28 28 28 28 28 28 28 28 28 28 28 28 36 28 28 28 28 28 0 0 25 25 25 25 68 68 68 68 68 68 68 25 25 67 25 67 67 67 25 25 25 25 25 25 25 
0 28 28 28 28 108 3 1 2 2 109 22 22 28 28 23 41 42 89 28 28 28 57 28 28 28 15 28 28 28 15 28 28 28 28 28 28 0 25 25 67 25 25 25 25 68 68 68 68 68 25 25 25 25 25 25 25 25 25 25 25 25 25 25 
0 28 28 28 28 28 108 109 22 22 22 22 22 22 22 108 3 66 21 28 28 28 28 28 28 15 28 28 28 28 28 28 28 74 28 28 28 0 25 25 67 67 67 25 25 68 68 68 68 25 25 25 67 67 67 25 67 67 25 67 67 67 67 67 
0 28 37 28 28 28 28 28 22 22 22 22 22 22 22 22 108 3 41 42 42 89 28 28 28 28 28 74 28 28 28 28 28 28 28 28 28 0 25 25 25 25 25 25 25 68 68 68 68 25 25 25 25 25 25 25 25 25 25 25 25 25 25 25 
0 28 28 28 14 28 28 28 22 22 22 22 22 22 22 22 22 23 66 66 66 41 42 42 42 42 42 42 89 28 28 28 28 14 28 28 0 0 25 67 67 25 25 25 25 68 68 68 68 68 25 67 67 67 25 25 25 25 25 25 25 25 25 25 
0 28 28 28 28 28 28 28 28 28 22 88 42 42 42 42 42 43 66 66 66 66 66 66 66 66 66 66 41 42 42 89 28 28 28 28 0 25 25 25 67 67 25 25 68 68 68 68 68 68 68 25 25 25 25 25 68 68 68 25 25 25 25 25 
0 28 28 14 22 22 22 22 22 22 22 108 2 2 2 2 3 66 66 66 66 66 66 66 66 66 66 66 66 66 66 41 42 89 28 28 0 25 67 25 25 25 25 25 68 68 25 25 25 68 68 68 68 68 68 68 68 68 68 68 68 68 25 25 
0 28 14 22 22 22 22 22 22 22 22 22 22 22 22 22 108 2 2 2 2 2 2 2 2 2 2 2 2 3 66 66 66 41 42 0 0 25 25 67 25 25 25 68 68 68 25 25 25 68 68 68 68 68 68 68 68 68 68 68 68 68 25 25 
0 28 14 22 22 22 22 28 37 28 22 22 22 22 22 22 28 28 28 28 28 28 28 28 28 28 28 28 22 108 3 66 66 66 138 25 25 68 68 25 25 25 68 68 68 25 25 25 25 25 25 25 25 25 25 25 25 25 25 25 25 25 25 25 
0 28 28 22 22 22 28 28 28 28 28 22 22 22 22 22 28 28 28 28 28 28 28 28 28 28 28 28 28 28 108 2 3 66 158 136 136 68 68 68 68 68 68 68 25 25 25 25 67 25 25 25 25 25 25 67 67 67 25 25 25 25 25 25 
0 28 28 22 22 22 22 28 28 28 28 22 22 22 22 22 28 37 28 28 28 14 28 28 28 28 14 28 28 14 28 28 108 2 2 2 2 3 68 68 68 68 68 68 25 25 25 25 25 25 25 25 25 25 25 25 25 25 25 25 67 67 67 67 
0 28 28 28 22 22 22 28 28 28 28 22 22 22 22 22 28 28 28 28 28 28 28 28 28 28 28 28 28 28 28 28 28 0 0 0 6 193 194 68 68 68 68 25 25 25 25 25 67 25 67 67 67 67 67 67 67 25 25 25 25 25 25 67 
0 28 28 14 22 22 22 22 28 28 22 22 22 22 22 22 14 28 28 14 28 28 28 28 28 28 14 28 28 28 0 0 0 0 25 25 0 0 68 68 68 68 25 25 25 25 25 25 25 25 25 25 25 25 25 25 25 25 25 0 0 0 0 0 
0 28 14 28 28 22 22 22 28 14 22 22 22 22 22 22 28 28 28 28 28 28 28 28 28 28 28 28 0 0 0 25 25 25 25 25 25 25 68 68 25 25 25 25 25 67 67 25 25 25 25 25 25 25 25 67 67 0 0 0 28 28 28 0 
0 28 28 28 28 14 28 28 28 28 28 28 28 28 28 28 28 28 28 28 28 28 28 28 28 0 0 0 0 25 25 25 25 25 25 25 25 25 68 68 25 25 25 25 25 25 25 67 67 67 25 25 25 25 25 25 0 0 28 28 28 28 28 0 
0 28 28 28 28 28 28 28 28 28 28 28 28 28 28 28 28 28 28 28 0 0 0 0 0 0 25 25 25 25 25 25 25 25 25 25 25 25 68 68 68 25 25 25 25 25 25 25 25 25 25 25 25 25 0 0 0 28 28 28 28 28 28 0 
0 0 0 0 0 0 0 0 0 0 0 0 0 0 0 0 0 0 0 0 0 25 25 25 25 25 25 25 25 25 25 25 67 67 25 25 25 25 25 68 68 25 25 25 25 25 67 67 25 25 25 25 25 0 0 28 28 28 28 28 28 28 28 0 
25 25 25 25 25 25 25 25 25 25 25 25 25 25 25 25 25 25 25 25 25 25 25 25 25 25 25 25 25 25 25 25 25 67 67 25 25 25 68 68 68 25 25 25 25 25 25 67 67 25 25 25 0 0 28 28 28 28 28 28 28 28 28 0 
25 25 67 67 25 25 25 25 25 25 25 25 25 25 25 25 25 25 25 67 67 67 25 25 25 25 25 67 67 67 25 25 25 25 25 67 25 25 25 25 68 68 25 25 67 67 25 25 25 25 25 0 0 28 28 28 28 75 28 28 28 28 28 0 
25 25 25 25 67 67 67 25 25 25 25 25 25 25 25 25 25 25 25 25 25 25 67 67 25 25 25 25 25 67 67 25 25 25 25 25 67 67 25 25 68 68 68 25 25 25 67 25 0 0 0 0 28 28 28 28 28 28 28 28 28 28 28 0 
25 25 25 25 67 67 25 25 25 25 25 25 25 25 25 25 25 25 25 25 25 25 25 25 25 25 25 25 25 25 25 67 67 25 25 25 25 67 25 25 25 68 68 68 25 25 25 0 0 28 28 28 28 28 28 28 28 28 28 28 28 28 28 0 
25 67 25 25 25 25 25 25 25 25 25 25 25 25 25 25 25 25 25 25 25 25 25 25 67 67 67 67 25 25 25 25 67 67 67 25 25 25 25 25 25 68 68 68 68 25 0 0 28 28 28 28 28 28 28 28 28 28 28 28 28 28 28 0 
25 67 67 25 25 25 25 25 25 25 25 25 25 25 25 25 25 25 25 25 25 25 25 25 25 25 25 25 67 67 25 25 25 25 25 25 25 25 25 25 25 25 25 68 68 68 93 28 28 28 28 28 28 28 28 74 28 28 28 28 28 28 28 0 
25 25 67 67 25 25 25 25 25 25 25 25 25 25 25 25 25 25 25 25 25 25 25 25 25 25 25 25 25 25 25 25 25 25 25 25 25 25 25 86 233 233 87 68 68 68 152 28 28 28 28 28 28 28 28 28 28 28 28 28 28 28 28 0 
67 25 25 25 25 67 67 25 25 25 25 25 25 25 25 25 25 25 25 67 67 67 67 67 67 67 25 25 25 25 25 25 25 25 25 0 0 0 0 46 133 134 68 68 68 68 152 28 28 28 77 28 28 28 28 28 28 74 28 28 28 28 28 0 
67 67 25 25 67 25 25 67 67 67 25 25 25 25 25 25 25 25 25 25 25 25 25 25 25 25 25 25 25 25 0 0 0 0 0 0 28 28 28 28 28 154 68 68 68 68 152 28 28 28 28 28 28 28 75 28 28 28 28 28 28 28 28 0 
0 0 0 0 0 67 25 25 25 25 67 67 25 25 25 25 25 25 25 25 25 25 25 25 25 0 0 0 0 0 0 28 28 28 28 28 28 28 28 28 92 174 132 133 133 133 113 28 28 28 28 28 28 28 28 28 28 28 28 28 28 28 28 0 
0 28 28 28 0 0 0 0 0 25 25 25 67 67 67 67 67 67 25 25 0 0 0 0 0 0 28 28 28 28 28 28 28 28 28 28 28 28 28 28 112 133 113 28 28 28 77 28 28 28 28 28 28 28 28 28 28 28 28 28 28 28 28 0 
0 28 28 28 28 28 28 28 0 0 0 0 0 0 0 0 0 0 0 0 0 28 28 28 28 28 28 28 28 28 28 28 28 28 28 28 28 28 28 28 28 28 28 28 28 28 28 28 28 28 28 28 28 28 28 28 28 28 28 28 28 28 28 0 
0 28 28 28 28 28 28 28 28 28 28 28 28 28 28 28 28 28 28 28 28 28 28 28 28 28 28 28 28 28 28 28 28 77 28 28 28 28 28 28 28 77 77 28 28 28 28 28 28 28 28 28 28 28 28 28 28 28 28 28 28 28 28 0 
0 28 28 28 28 28 28 28 28 28 28 28 28 28 28 28 28 28 28 28 28 28 28 28 28 28 28 28 28 28 28 28 28 28 28 28 28 28 28 28 28 28 28 28 28 28 28 76 28 28 28 28 76 28 28 28 28 28 28 28 28 28 28 0 
0 28 28 28 28 28 22 28 28 28 28 28 28 28 28 28 76 28 28 77 77 77 22 77 22 77 77 77 28 28 28 28 28 28 28 28 75 28 28 77 28 28 28 28 28 28 28 28 28 28 28 28 28 28 28 28 28 28 28 28 28 28 28 0 
0 28 28 28 28 28 28 28 28 75 28 28 28 28 75 28 76 77 22 22 22 22 22 22 22 28 28 28 28 28 28 77 28 28 28 28 28 28 28 77 28 28 28 28 28 28 28 28 28 28 28 28 28 28 28 28 28 28 28 28 28 28 28 0 
0 28 28 28 28 28 28 75 28 28 28 28 28 28 28 76 22 22 28 77 22 22 22 22 77 28 28 28 28 28 28 28 28 28 28 77 28 28 28 28 28 28 76 28 28 28 28 28 28 28 28 74 28 28 28 28 28 28 28 28 28 28 28 0 
0 28 28 28 28 28 28 28 28 28 28 28 28 75 28 76 76 76 28 28 28 22 77 77 77 28 28 28 28 28 28 28 28 28 28 28 28 28 28 28 28 28 28 28 28 28 28 28 28 28 28 28 28 28 28 28 28 28 28 28 28 28 28 0 
0 28 28 28 28 28 28 75 28 28 28 28 28 28 28 76 28 76 28 28 28 28 28 28 28 28 28 28 28 28 28 28 28 28 28 28 28 28 28 28 28 28 28 28 28 28 28 28 28 28 28 28 28 28 28 28 28 28 28 28 28 28 28 0 
0 28 28 28 28 28 28 28 28 28 28 28 28 28 28 28 28 28 28 28 28 28 28 28 28 28 28 28 28 28 28 28 28 28 28 28 28 28 28 28 28 28 28 28 28 28 28 28 28 28 28 28 28 28 28 28 28 28 28 28 28 28 28 0 
0 0 0 0 0 0 0 0 0 0 0 0 0 0 0 0 0 0 0 0 0 0 0 0 0 0 0 0 0 0 0 0 0 0 0 0 0 0 0 0 0 0 0 0 0 0 0 0 0 0 0 0 0 0 0 0 0 0 0 0 0 0 0 0