25 25 67 25 86 45 45 45 45 45 45 45 45 45 45 45 45 45 45 45 45 45 45 45 45 45 87 25 25 25 25 25 25 67 25 25 25 25 25 25 67 25 25 25 25 67 25 25 25 67 25 25 67 25 25 25 25 25 25 67 25 25 67 25 
25 67 25 86 46 0 0 0 0 0 0 0 0 0 0 0 0 0 0 0 63 64 0 0 0 0 44 45 45 45 45 45 45 45 45 45 45 87 25 86 45 45 45 45 45 45 45 45 45 45 45 45 45 45 45 45 87 86 45 45 45 87 25 25 
67 25 67 26 0 0 61 62 0 0 0 0 0 56 0 56 0 0 0 0 83 84 0 0 0 0 0 0 0 0 0 0 0 0 0 0 0 44 45 46 0 0 0 0 0 0 0 0 0 0 0 0 0 0 0 0 24 26 0 0 0 24 25 25 
25 25 86 46 0 0 81 82 0 0 65 0 56 0 63 64 0 0 0 0 103 104 0 0 0 0 0 0 16 16 0 0 0 0 0 0 0 0 0 0 0 57 0 0 0 0 0 0 0 0 0 0 0 0 0 17 24 26 0 0 0 24 67 25 
25 25 26 0 0 0 101 102 0 0 0 0 56 0 83 84 0 0 0 56 0 0 0 0 16 37 16 17 0 0 0 16 0 0 0 0 0 0 0 0 0 0 0 0 0 0 0 0 0 0 0 0 0 85 0 0 24 106 6 0 0 24 67 25 
25 86 46 0 0 0 0 0 0 0 75 0 56 0 103 104 0 0 65 0 0 0 37 0 16 37 17 36 14 16 0 0 0 0 0 0 0 0 0 0 85 0 0 0 0 85 0 0 0 0 85 0 0 0 85 0 44 87 26 0 0 24 25 25 
25 26 0 0 0 0 0 61 62 0 0 65 0 0 0 0 0 0 0 0 63 64 0 37 17 16 16 14 36 16 16 16 0 0 57 0 0 0 114 115 116 0 0 0 0 0 0 0 0 0 0 0 0 0 0 0 0 24 26 0 0 24 25 25 
25 26 0 0 0 0 0 81 82 0 0 0 75 0 0 65 0 0 0 0 83 84 0 16 17 34 17 34 16 16 0 0 0 0 0 0 0 0 0 0 85 0 94 0 0 0 0 0 0 0 0 0 0 0 0 0 0 24 26 0 0 24 25 25 
67 26 0 0 0 75 0 101 102 65 0 0 74 74 0 0 0 0 0 0 103 104 0 17 17 16 14 14 0 16 0 0 0 0 0 0 0 0 0 0 0 0 0 0 0 95 0 0 0 0 0 0 0 0 0 0 0 24 106 6 0 24 25 25 
25 26 0 0 85 0 0 0 0 0 0 0 0 0 85 0 63 64 0 0 0 0 37 17 34 17 0 0 0 0 0 0 0 0 74 0 0 0 0 0 0 0 0 0 0 0 96 0 0 96 0 0 0 0 0 0 0 44 87 26 0 24 25 25 
25 26 0 0 0 0 0 0 37 0 0 61 62 0 0 0 83 84 0 0 0 0 0 34 14 0 14 0 114 115 116 0 0 0 0 0 0 0 85 0 0 0 0 0 0 0 0 0 0 0 0 0 0 0 0 0 0 0 24 26 0 24 25 67 
25 26 0 85 0 0 85 0 0 0 0 81 82 0 0 0 103 104 0 0 0 0 85 34 0 14 0 0 0 0 0 0 0 0 0 85 0 0 0 0 0 0 95 0 0 0 0 0 0 0 0 0 0 0 0 0 0 0 24 26 0 24 25 25 
25 26 0 0 63 64 0 0 0 75 0 101 102 0 85 0 0 0 0 0 0 0 0 14 14 0 16 0 0 0 0 16 0 0 0 0 0 0 0 0 95 0 0 0 0 96 0 96 0 0 0 0 0 0 0 17 15 0 24 26 0 44 87 25 
25 26 0 0 83 84 0 0 85 0 0 0 0 0 0 0 0 0 63 64 0 85 0 0 16 16 0 0 0 0 0 0 0 16 0 0 0 0 0 0 0 0 0 96 0 0 0 0 0 0 69 0 0 0 0 0 0 0 24 26 0 0 24 25 
25 26 0 0 103 104 0 0 0 0 0 0 0 0 0 0 0 0 83 84 0 0 0 16 16 0 0 74 0 0 0 56 0 0 0 0 0 0 0 0 95 0 0 0 0 95 0 0 0 0 0 0 0 96 0 0 15 0 24 26 0 0 24 25 
25 26 0 0 0 0 0 37 0 0 0 0 37 63 64 0 0 0 103 104 0 0 0 0 0 0 0 77 0 0 0 0 0 0 77 0 0 0 0 0 0 0 0 0 95 0 0 0 0 0 0 0 95 0 0 0 0 0 24 26 0 0 24 25 
25 26 0 0 0 0 63 64 0 85 0 0 0 83 84 0 85 0 0 0 0 85 0 0 37 0 0 57 0 74 0 0 56 0 0 0 0 0 0 0 0 0 114 115 116 0 0 0 0 0 0 0 0 0 0 69 0 0 24 26 0 0 24 25 
25 26 0 0 0 0 83 84 0 0 0 0 0 103 104 0 0 85 0 0 0 0 0 0 77 0 0 0 0 0 57 0 0 0 0 0 0 0 0 0 0 0 0 0 0 0 0 0 0 0 57 0 0 0 0 0 0 0 24 26 0 0 24 25 
25 26 0 0 0 0 103 104 0 0 0 0 0 0 0 0 0 0 0 0 0 0 0 0 0 0 0 0 0 0 0 0 0 0 0 0 0 0 0 4 5 5 5 5 5 5 5 5 6 0 0 0 0 0 0 0 85 0 24 26 0 0 24 25 
25 106 5 6 0 0 0 0 0 0 0 0 0 0 0 0 0 0 0 0 4 5 5 5 5 5 5 5 5 6 0 0 0 0 0 0 0 0 0 24 25 25 25 25 25 25 25 25 26 0 0 0 0 0 0 0 0 0 24 26 0 0 24 67 
25 25 25 106 5 5 5 5 5 5 5 5 5 5 5 5 5 5 5 5 107 25 25 25 25 25 25 25 25 26 0 0 0 0 56 0 4 5 5 107 25 25 25 67 25 25 25 25 26 0 0 0 0 0 0 0 15 0 24 26 0 0 24 25 
25 25 25 25 25 25 25 25 25 25 25 25 25 25 25 25 25 25 25 25 25 25 25 25 25 25 25 25 25 106 6 0 0 0 0 0 24 25 25 25 67 25 25 25 25 25 25 25 26 0 0 0 0 0 0 0 0 0 24 26 0 0 24 25 
25 25 25 25 25 25 25 25 25 25 25 25 25 25 25 25 25 25 25 25 25 25 25 25 25 67 25 25 25 25 26 0 0 0 0 0 44 87 25 25 25 25 25 25 67 25 25 25 26 0 15 0 0 0 0 0 0 4 107 26 0 0 24 25 
67 25 25 25 25 25 67 25 25 25 25 25 25 25 25 25 67 25 25 25 25 25 67 25 25 25 25 25 25 25 106 6 0 76 0 0 0 44 87 25 25 25 25 144 25 25 25 25 26 0 0 0 0 97 0 0 0 24 25 26 0 0 24 25 
25 25 25 67 25 25 25 25 25 25 25 25 25 25 25 25 25 25 25 25 25 25 25 25 25 25 25 67 25 25 25 106 6 0 0 0 0 0 24 25 25 25 145 25 146 25 25 25 26 0 0 0 0 0 0 76 0 24 25 26 0 0 24 25 
25 25 25 25 25 25 25 25 67 25 25 67 25 25 25 25 25 25 25 25 25 25 25 25 25 25 25 25 25 25 25 25 26 0 0 76 0 0 44 87 25 25 105 142 143 25 25 86 46 0 0 0 97 0 0 0 0 44 87 26 0 0 24 25 
25 67 25 25 25 25 25 25 25 25 25 25 25 25 25 25 25 25 25 25 25 25 25 67 25 25 25 25 25 25 25 25 106 6 0 0 0 0 0 24 25 25 67 25 145 142 25 26 0 0 0 0 0 0 0 0 56 0 24 26 0 4 107 25 
25 25 25 25 67 25 25 25 25 25 25 25 25 25 25 25 25 25 25 67 25 25 25 25 25 25 67 25 67 25 25 25 25 106 6 0 0 0 0 24 25 25 25 143 105 25 25 26 0 56 0 0 95 0 0 0 0 0 24 106 5 107 25 25 
25 25 67 25 25 25 25 25 25 25 25 25 25 25 25 25 25 25 25 25 67 25 25 25 25 25 25 25 25 25 25 25 25 25 106 6 0 0 0 44 87 25 25 25 25 25 25 26 0 0 0 0 0 0 0 0 74 0 44 87 25 25 25 25 
25 25 25 25 25 25 25 67 25 25 25 25 25 67 25 25 25 25 25 25 25 25 25 25 25 25 25 25 25 25 25 25 25 25 25 26 0 75 0 0 24 25 25 25 25 142 25 26 0 0 0 0 0 0 0 0 0 0 0 44 87 25 25 25 
25 25 25 25 25 25 25 25 25 25 25 25 25 67 25 25 25 25 25 25 25 25 25 25 121 25 25 25 25 25 25 67 25 25 25 106 6 0 0 0 44 87 25 25 25 105 25 26 0 15 0 95 0 0 0 34 15 0 0 0 24 25 25 25 
25 67 25 25 25 67 25 25 25 25 25 25 25 25 25 25 25 25 25 125 67 121 25 126 25 67 67 67 25 25 25 25 25 25 25 25 26 0 0 0 0 24 25 25 25 25 25 26 0 0 0 0 95 0 0 0 0 54 0 0 24 25 67 25 
25 25 25 25 25 25 25 105 25 25 105 25 105 25 25 25 25 25 125 25 125 105 126 126 126 126 126 123 67 25 25 25 25 25 25 25 106 6 0 0 0 44 25 25 25 25 25 26 0 75 0 0 0 0 0 0 0 0 0 0 24 25 25 67 
25 67 25 25 25 105 25 25 25 25 105 25 25 67 67 25 25 125 121 25 25 121 25 121 25 123 25 123 25 25 67 25 25 67 25 25 25 26 0 0 0 0 44 87 25 25 25 26 0 0 0 95 0 0 0 0 0 0 57 0 24 25 25 25 
67 25 25 25 25 25 25 25 25 25 25 25 25 25 25 25 25 25 25 25 25 25 25 25 25 25 25 25 25 25 25 25 25 25 25 25 25 106 6 0 0 0 0 24 25 25 25 26 0 0 0 0 0 0 0 0 0 0 0 0 44 87 25 25 
67 86 45 45 45 45 45 45 45 45 45 45 45 45 45 45 45 45 45 45 45 45 45 45 45 45 45 45 45 45 45 45 87 67 25 25 25 25 106 6 0 75 0 44 45 87 25 26 0 0 0 0 0 94 0 0 0 34 0 76 0 24 25 25 
25 26 11 72 72 72 72 72 72 72 72 72 72 72 72 72 72 72 72 72 72 72 72 72 72 72 72 72 72 72 72 13 24 25 25 25 25 25 25 106 6 0 0 0 0 44 87 26 0 0 0 0 94 0 0 127 129 0 0 0 0 24 25 25 
67 26 30 15 0 71 12 73 0 0 0 0 0 0 0 0 17 0 0 0 0 0 0 0 0 0 0 0 0 0 0 30 24 25 25 25 25 67 25 25 106 6 0 0 0 0 44 46 0 0 94 0 0 0 127 151 150 129 0 0 0 24 25 25 
25 26 30 0 0 0 30 0 0 11 72 72 72 72 72 72 72 72 72 72 72 72 72 72 72 72 72 72 72 73 0 30 24 25 67 25 25 25 25 25 25 26 0 0 0 0 0 0 0 0 94 0 0 127 151 148 148 149 0 0 4 107 67 25 
25 26 31 72 13 0 30 17 0 50 0 0 0 0 0 0 0 0 0 0 0 0 0 17 0 0 0 0 0 0 0 30 24 25 25 25 25 25 25 25 25 26 0 0 54 0 76 0 0 0 0 0 127 151 148 148 148 149 0 0 24 25 25 25 
25 26 30 0 30 0 30 0 0 0 0 0 0 17 0 0 11 72 72 72 72 72 72 72 72 73 0 10 0 10 0 30 24 25 25 25 25 25 25 25 25 26 0 0 76 0 0 0 0 0 0 0 167 131 148 148 148 149 0 0 44 87 25 25 
25 26 30 15 30 0 30 0 71 72 72 72 72 72 13 0 30 0 0 0 0 0 0 0 0 0 0 30 0 30 0 30 24 25 25 67 25 25 25 25 25 106 6 0 0 0 0 0 0 0 0 0 0 147 148 148 130 169 0 0 0 24 25 67 
25 26 30 0 30 0 30 0 0 0 0 0 0 0 30 0 30 0 71 72 72 72 72 72 72 13 0 30 0 30 0 30 24 25 25 25 25 67 25 25 25 25 26 0 0 0 0 0 0 0 0 0 0 167 168 168 169 0 0 0 0 24 25 25 
25 26 30 0 30 15 51 72 72 72 13 15 0 0 30 0 30 0 0 0 0 0 15 0 0 30 0 30 0 30 0 30 24 25 25 67 25 25 25 25 25 86 46 0 0 0 0 0 0 0 0 0 0 0 0 0 0 0 0 0 0 24 25 25 
67 26 30 0 30 0 0 0 0 0 30 0 17 0 30 0 30 0 17 0 17 0 0 0 0 30 0 50 0 30 0 30 24 25 25 25 25 25 25 25 86 46 0 0 0 0 0 0 0 0 0 0 0 0 0 0 0 0 0 0 0 44 87 25 
25 26 30 0 51 72 72 73 0 0 30 0 0 0 30 0 30 0 0 0 0 11 72 12 72 33 0 0 37 30 0 30 24 25 25 25 25 67 25 25 26 0 0 17 0 0 0 0 0 0 0 0 0 0 0 0 0 0 0 69 0 0 24 25 
25 26 30 17 0 0 0 0 15 0 30 15 15 0 30 0 51 72 72 73 0 30 0 30 0 30 0 10 0 30 0 30 24 25 25 25 25 25 25 25 26 0 0 0 0 0 0 0 0 0 0 0 0 0 0 0 0 0 0 0 0 0 24 25 
25 26 30 0 11 72 72 72 13 0 50 0 0 0 30 0 0 0 0 15 0 30 0 30 0 30 0 30 0 30 0 30 24 25 25 67 25 25 25 25 26 0 0 0 0 0 0 0 0 0 0 0 0 0 0 0 0 0 0 0 0 0 24 25 
25 26 30 0 30 0 0 0 30 0 0 0 0 71 53 0 11 72 13 0 0 30 15 30 0 30 0 30 0 30 0 30 24 25 25 25 25 25 25 25 106 6 0 0 0 0 0 0 0 0 0 0 0 0 0 0 0 0 0 0 0 0 24 25 
25 26 30 0 30 0 11 72 53 15 71 73 0 0 0 0 30 0 30 0 71 53 0 30 0 30 0 30 0 30 0 30 24 25 25 25 25 25 67 25 25 106 6 0 17 0 17 0 0 0 0 0 0 0 0 0 0 0 0 0 0 0 24 67 
67 26 30 0 30 0 50 0 0 0 0 0 0 71 72 72 53 0 30 0 0 0 0 30 0 50 0 30 0 30 0 30 24 25 67 25 25 25 25 25 25 25 106 6 0 0 0 0 0 0 0 0 0 0 0 0 0 0 0 0 0 0 24 25 
25 26 30 0 30 0 0 15 0 10 0 0 15 0 0 75 0 0 30 0 71 72 72 53 0 0 0 50 0 30 0 30 24 25 25 25 25 25 25 25 25 25 25 26 0 0 0 17 0 0 0 0 0 0 0 0 0 0 0 69 0 0 24 25 
25 26 30 0 51 72 13 0 71 52 72 13 0 0 0 0 0 11 53 0 0 0 0 0 0 10 0 0 0 30 0 30 24 25 25 25 25 67 25 25 25 25 25 106 6 0 0 0 16 0 0 0 0 0 0 0 0 0 0 0 0 0 24 25 
25 26 30 77 0 0 30 77 0 0 0 30 0 15 10 0 11 53 0 0 10 0 15 71 72 52 72 13 0 30 0 30 24 25 67 25 25 25 25 25 25 25 25 25 26 0 0 0 0 0 0 0 0 0 0 0 0 0 0 0 0 0 24 25 
25 26 30 0 10 0 30 0 0 15 0 30 0 0 30 0 30 0 15 0 30 77 0 0 0 0 0 30 0 30 0 30 24 25 25 25 25 25 25 25 25 25 25 25 26 0 0 15 0 0 0 0 0 0 0 0 0 0 0 0 0 0 24 67 
25 26 31 12 53 0 51 72 72 73 0 51 73 0 30 0 51 72 13 0 30 0 0 15 0 0 0 30 0 50 0 30 24 25 25 25 67 25 67 25 67 25 25 25 26 0 0 0 0 0 15 0 0 0 0 0 0 15 0 0 0 0 24 25 
67 26 31 33 0 36 0 0 0 0 0 0 0 0 30 0 0 0 30 0 51 72 72 72 72 72 72 33 0 0 37 30 44 45 45 45 45 45 45 45 45 45 45 45 46 0 0 0 0 0 0 0 0 0 0 0 55 0 0 0 0 0 24 25 
25 26 31 53 0 11 72 72 13 0 71 72 72 72 33 0 10 0 30 0 0 0 0 0 0 0 0 51 72 72 72 52 72 72 72 72 72 72 72 72 72 72 72 72 72 72 73 0 0 0 17 0 0 0 0 0 0 0 15 0 0 0 24 25 
25 26 30 0 0 30 0 0 30 0 0 0 0 0 30 0 51 72 52 12 72 72 72 72 72 13 0 0 0 0 0 0 0 0 0 0 0 0 0 0 0 0 0 0 0 0 0 0 0 0 0 0 15 0 0 0 0 0 0 0 0 0 24 25 
25 26 30 0 0 30 0 15 51 72 72 72 72 72 53 15 0 0 0 30 0 0 15 0 0 31 72 72 72 72 72 12 72 72 72 72 72 72 72 72 72 72 72 72 72 72 73 0 0 0 0 0 0 0 0 0 0 0 0 0 0 0 24 25 
25 26 30 0 0 30 0 0 0 0 0 0 0 0 0 0 0 15 0 30 0 0 0 0 0 30 0 0 0 0 0 30 4 5 5 5 5 5 5 5 5 5 5 5 5 6 0 0 0 0 114 115 115 115 115 115 115 115 116 0 0 4 107 67 
25 26 51 72 72 52 72 72 72 72 72 72 72 72 72 72 72 72 72 52 72 72 72 72 72 52 72 72 72 72 72 53 24 25 25 25 25 67 25 25 25 25 25 25 25 26 0 0 0 0 0 0 0 0 0 0 0 0 0 0 4 107 25 25 
67 106 5 5 5 5 5 5 5 5 5 5 5 5 5 5 5 5 5 5 5 5 5 5 5 5 5 5 5 5 5 5 107 25 25 25 67 25 25 25 25 67 25 25 25 106 5 5 5 5 5 5 5 5 5 5 5 5 5 5 107 25 25 67 
25 25 67 25 25 25 25 25 67 25 25 25 25 25 25 25 25 67 25 25 25 25 25 25 25 25 25 67 25 25 25 25 25 67 67 25 25 25 67 25 25 25 67 25 25 25 25 25 25 25 25 25 25 67 25 25 25 25 25 25 67 25 67 25
