25 25 25 25 25 25 25 25 67 25 25 25 25 25 25 25 25 25 25 25 25 25 25 25 25 25 25 25 67 25 25 25 25 25 25 25 25 25 25 25 25 25 25 25 25 25 25 25 25 25 67 25 25 25 25 25 25 25 25 25 25 25 25 25 
25 25 25 25 25 25 25 25 25 25 25 25 25 67 25 25 25 25 25 25 25 178 233 233 233 233 233 233 233 233 233 233 233 233 233 233 233 233 233 233 233 233 233 233 233 233 233 233 233 233 233 233 233 233 233 233 233 233 179 25 25 25 25 25 
25 25 25 25 25 25 25 25 25 25 25 25 25 25 25 25 25 25 25 25 178 234 0 0 0 0 0 0 0 0 0 0 0 0 0 0 0 0 0 0 0 19 0 0 0 0 0 0 0 0 0 0 0 0 0 0 0 0 212 25 25 25 25 25 
25 25 25 25 25 25 25 25 25 25 67 25 25 25 25 25 25 25 25 25 214 0 0 0 0 0 0 0 0 0 0 0 0 0 0 0 0 0 0 0 0 19 19 19 19 0 0 0 0 0 0 0 0 0 0 0 0 0 232 179 25 25 25 25 
25 25 25 25 25 67 25 25 25 25 25 25 25 25 25 67 25 25 25 25 214 0 0 0 0 0 0 0 0 0 19 0 0 0 0 69 0 0 19 0 0 0 0 0 20 19 20 19 0 0 0 19 19 19 19 0 0 0 0 212 25 67 25 25 
25 25 25 25 25 25 25 25 25 25 25 25 25 25 25 25 25 25 25 25 214 0 0 0 0 0 0 0 0 0 0 0 0 0 0 0 0 0 0 0 0 0 0 0 0 0 0 19 19 0 19 0 0 0 19 19 0 0 0 212 25 25 25 25 
25 25 25 25 25 25 25 25 25 25 25 25 25 25 25 67 25 25 25 25 214 0 0 0 0 0 0 0 0 0 0 0 20 0 0 0 0 0 0 0 0 0 0 0 0 0 0 0 19 19 20 0 0 0 0 19 19 0 0 212 25 25 25 121 
25 25 25 25 25 25 25 25 25 67 25 25 25 25 25 25 25 25 25 25 198 194 0 0 0 0 0 0 0 0 0 0 0 0 0 0 0 0 0 0 0 0 0 0 0 0 0 0 0 0 20 0 0 0 0 0 20 0 0 212 25 121 25 25 
25 25 25 25 25 67 25 25 25 25 25 25 25 25 25 25 25 25 25 25 25 214 0 0 0 0 0 0 0 0 0 0 0 0 0 0 0 0 0 0 0 0 0 0 0 0 0 0 0 0 0 0 0 0 0 0 0 0 0 212 25 121 25 121 
25 25 25 25 25 25 25 25 25 124 25 25 25 25 25 25 25 25 25 25 25 198 194 0 0 0 0 0 0 0 0 0 0 0 0 0 0 0 0 0 0 0 0 0 0 0 0 0 0 0 0 0 0 0 0 19 0 0 0 212 25 25 25 25 
25 25 25 25 124 25 25 25 25 25 25 25 25 25 125 25 25 25 25 25 25 25 198 193 194 0 0 0 0 0 0 0 0 0 0 0 0 0 0 0 0 0 0 0 0 0 0 0 0 0 0 0 0 0 19 0 0 0 0 212 25 25 121 25 
25 25 25 25 25 25 25 25 25 25 25 25 25 25 25 25 25 25 25 25 25 25 25 25 198 193 193 193 194 0 0 0 0 0 0 0 0 0 0 0 0 0 0 0 0 0 0 0 0 0 0 0 0 0 0 20 0 0 0 232 179 25 121 25 
25 25 25 25 25 25 25 178 233 233 233 233 233 233 233 233 233 233 179 125 25 25 25 25 25 25 25 25 198 193 194 0 0 0 0 0 0 0 0 0 0 0 0 0 0 0 0 0 0 0 0 0 0 0 0 20 0 0 0 0 212 121 25 25 
25 25 25 25 25 178 233 234 0 0 0 0 0 0 0 0 0 0 232 233 233 179 25 25 25 25 25 25 25 25 214 0 0 0 0 0 0 0 0 0 0 0 0 0 0 0 0 0 0 0 0 0 0 20 20 0 0 0 0 0 212 25 25 25 
25 25 124 25 25 214 0 0 0 0 0 0 0 0 0 0 0 0 0 0 0 232 233 233 179 25 25 25 122 25 214 0 0 0 0 0 0 0 0 0 0 0 0 0 0 0 20 20 0 0 0 0 0 0 0 20 20 0 0 0 212 25 121 25 
25 124 25 25 178 234 0 0 0 0 69 0 0 0 0 0 0 0 0 0 0 0 0 0 232 233 179 25 125 25 214 0 0 0 0 0 0 0 0 0 0 0 0 0 0 0 19 19 20 0 0 0 0 0 0 19 20 20 0 0 232 179 25 25 
25 25 25 25 214 0 0 0 0 0 0 0 0 0 0 0 0 0 0 0 0 0 0 0 0 0 232 179 25 25 214 0 0 0 0 0 0 0 0 0 0 0 0 0 0 20 19 19 20 0 0 0 0 0 0 0 0 20 0 0 0 212 25 25 
25 25 25 178 234 0 0 0 0 0 0 0 0 0 0 0 0 0 0 0 0 0 0 0 0 0 0 232 233 179 214 0 0 0 0 0 0 0 0 0 19 0 0 0 0 0 20 19 0 0 0 0 0 0 0 0 0 20 0 0 0 212 25 25 
25 25 25 214 0 0 0 0 0 0 0 0 0 0 0 0 0 0 19 19 0 0 0 0 0 0 0 0 0 232 234 0 0 0 0 0 0 0 0 0 20 20 0 0 0 0 0 0 0 0 0 0 0 0 0 0 0 20 0 0 0 212 25 25 
25 25 25 214 0 0 0 0 0 19 19 0 0 0 0 19 19 20 0 0 19 19 0 0 0 0 0 0 0 0 0 0 0 0 0 0 0 0 0 0 0 20 20 0 0 0 0 0 0 0 0 0 0 0 0 0 20 0 0 0 0 212 67 25 
25 25 25 198 194 0 0 0 0 0 0 19 19 20 19 0 0 0 0 0 20 0 20 0 0 0 0 0 0 0 0 0 0 0 0 0 0 0 0 0 0 0 0 0 0 0 0 0 0 0 0 0 0 20 0 20 20 0 0 0 0 212 25 25 
25 25 25 25 214 0 0 0 0 0 0 0 20 19 0 0 0 0 0 0 0 0 0 19 20 0 0 0 0 0 0 0 0 0 0 0 0 0 0 0 0 0 0 0 0 0 0 0 0 0 0 0 0 0 0 0 0 20 0 0 0 212 25 25 
25 25 25 25 214 0 0 0 0 0 0 0 0 0 0 0 0 0 0 0 0 0 0 0 0 19 0 0 0 0 0 0 0 0 0 0 0 0 0 0 0 0 0 0 0 0 0 0 0 0 0 0 0 0 0 0 0 0 20 0 0 232 179 25 
25 25 25 25 214 0 19 0 0 0 0 0 0 0 0 0 0 0 0 0 0 0 0 0 0 19 0 0 0 0 0 0 0 0 0 0 0 0 0 0 0 0 0 0 0 0 0 0 0 0 0 0 0 0 0 0 0 0 20 0 0 0 212 25 
25 25 25 25 214 0 0 19 0 0 0 0 0 0 0 0 0 0 0 0 0 0 0 0 0 19 0 0 0 0 0 0 0 0 0 0 0 0 0 0 0 0 0 0 0 0 0 0 0 0 0 0 0 0 0 0 0 0 20 0 0 0 212 25 
25 25 126 25 214 0 0 20 0 0 0 0 0 0 0 0 0 0 19 0 0 0 0 0 0 0 19 0 0 0 0 0 0 0 0 0 0 0 0 0 0 0 0 0 0 0 0 0 0 0 0 0 0 0 0 0 20 20 0 0 0 0 212 25 
25 25 25 25 214 0 0 19 0 0 0 0 0 0 0 0 0 0 0 0 0 0 0 0 20 19 20 0 0 0 0 0 0 0 0 0 0 0 0 0 0 0 0 0 0 0 0 0 0 0 0 0 0 0 0 0 0 20 0 0 0 0 212 25 
25 25 25 25 198 194 0 19 19 0 0 0 20 0 0 0 0 0 0 0 0 0 0 0 0 0 0 0 0 0 0 0 0 0 0 0 0 0 0 0 0 0 0 0 20 20 0 0 0 20 0 0 0 0 19 0 19 0 0 0 0 0 212 25 
25 25 25 25 25 198 194 0 19 20 0 0 0 0 0 0 0 20 20 20 19 19 0 0 0 0 0 0 0 0 0 192 194 0 0 0 0 0 0 0 0 0 20 20 0 0 20 0 0 0 0 20 19 0 0 20 0 0 0 0 0 0 212 25 
25 25 25 25 25 25 214 0 0 0 19 19 0 19 0 0 19 19 0 0 19 0 0 0 0 0 0 0 0 0 0 212 214 0 0 0 0 0 0 0 0 0 0 0 0 69 0 20 0 0 20 0 0 20 20 0 0 0 69 0 0 0 212 25 
25 25 25 25 25 25 198 194 0 0 0 19 19 20 19 20 0 0 0 0 20 0 0 0 0 0 0 0 0 0 192 199 214 0 0 0 0 0 0 0 0 0 0 0 0 0 0 0 20 19 20 0 0 0 0 0 0 0 0 0 0 0 212 25 
25 25 25 25 25 25 25 198 194 0 0 0 0 0 0 0 69 0 0 0 19 19 0 0 0 0 0 0 0 192 199 25 214 0 0 0 0 0 0 0 0 0 0 0 0 0 0 0 0 0 0 0 0 0 0 0 0 0 0 0 0 0 212 25 
25 25 25 25 25 25 25 25 198 193 194 0 0 0 0 0 0 0 0 0 0 0 0 0 0 0 0 0 192 199 25 25 214 0 0 0 192 193 193 194 0 0 0 0 0 0 0 0 192 193 193 193 193 193 193 193 193 193 193 193 193 193 199 25 
25 25 25 25 126 25 25 25 25 25 198 193 194 0 0 0 0 0 0 0 0 0 0 0 0 0 192 193 199 25 25 178 234 0 0 0 212 25 25 198 193 194 0 0 0 0 192 193 199 25 25 25 25 25 25 25 25 25 25 25 25 25 25 25 
25 25 25 25 25 25 25 25 25 25 25 25 214 0 0 0 0 0 0 0 0 0 0 192 193 193 199 25 25 25 25 214 0 0 0 0 212 25 25 25 25 198 193 193 193 193 199 25 25 25 25 25 125 25 25 25 122 25 25 25 25 25 25 25 
25 25 25 25 25 25 25 126 25 25 25 25 198 194 0 0 0 0 0 0 0 0 0 212 25 25 25 25 25 25 25 214 0 0 0 0 212 25 25 25 25 25 25 25 25 25 25 25 25 25 25 25 25 25 25 25 122 25 25 25 25 25 25 25 
25 25 25 25 25 25 25 25 67 25 25 25 25 214 0 0 0 0 0 0 0 192 193 199 25 25 25 25 25 25 25 214 0 0 0 192 199 25 25 25 25 25 25 25 25 25 25 25 25 25 25 25 67 25 25 25 25 25 25 25 25 121 25 25 
25 25 25 25 25 126 25 25 25 25 25 25 25 198 193 193 193 193 193 193 193 199 25 25 25 25 25 25 67 25 25 214 0 0 0 212 178 233 233 233 233 233 233 233 179 25 25 25 25 121 25 25 25 25 25 25 25 25 25 25 25 25 25 25 
25 25 25 25 25 25 25 25 25 25 25 25 25 25 25 25 25 25 25 25 25 25 25 25 25 25 25 25 25 25 25 214 0 0 0 232 234 0 0 0 0 0 0 0 232 233 179 25 25 25 25 25 25 25 125 25 124 25 25 25 25 25 25 25 
25 25 25 25 25 25 25 25 25 25 126 25 25 25 25 25 25 25 25 25 25 25 121 25 25 25 121 25 25 25 25 214 0 0 0 0 0 0 0 0 0 0 0 0 0 0 232 233 179 25 25 25 25 25 25 25 25 25 67 25 67 25 25 25 
25 25 25 25 25 25 25 25 25 126 25 25 25 25 25 178 233 233 179 25 25 25 25 25 25 25 25 25 25 25 25 214 0 0 0 0 0 0 0 0 0 0 0 0 0 0 0 0 232 233 179 25 25 25 25 25 25 25 25 25 25 25 25 25 
25 25 25 25 25 25 25 25 25 25 25 25 25 25 178 234 0 0 232 233 233 233 233 233 233 233 233 233 233 233 233 234 0 0 0 0 0 0 0 0 0 0 0 0 0 0 0 0 0 0 232 179 25 25 25 25 25 25 25 25 25 25 25 25 
25 25 25 25 25 25 25 25 25 25 25 178 233 233 234 0 0 0 0 0 0 0 0 0 0 0 0 0 0 0 0 0 0 0 0 0 0 0 0 0 0 0 0 0 0 0 0 0 0 0 0 232 179 25 25 126 25 124 25 25 25 67 25 25 
25 25 25 25 25 25 25 25 25 25 178 234 0 0 0 0 0 0 0 0 0 0 0 0 0 0 0 0 0 0 0 0 0 0 0 0 0 0 0 0 0 0 0 0 0 0 0 0 0 0 0 0 232 179 25 25 25 25 25 25 25 25 25 25 
25 25 25 25 25 25 25 25 25 25 214 0 0 0 0 0 0 0 0 0 0 0 0 0 0 0 0 0 0 0 0 0 11 73 0 71 13 0 0 0 0 0 0 0 0 0 0 0 0 0 0 0 0 232 233 179 25 25 25 25 25 25 67 25 
25 25 25 25 25 25 25 25 25 25 214 0 0 0 0 0 20 0 0 0 0 0 0 0 0 0 0 0 0 0 0 11 53 0 0 0 51 13 0 0 0 0 0 114 115 116 0 0 0 69 0 0 0 0 0 232 233 179 25 25 25 25 25 25 
25 25 25 25 25 67 25 25 25 25 214 0 0 0 0 0 0 0 0 0 0 0 0 0 0 0 0 0 0 0 71 33 0 0 0 0 0 31 73 0 0 0 0 0 0 0 0 0 0 0 0 0 0 0 0 0 0 232 179 25 25 25 25 25 
25 25 25 25 25 25 25 25 25 25 214 0 0 0 0 20 0 0 0 0 0 0 0 0 0 0 0 0 0 0 0 51 13 0 0 0 11 53 0 0 0 0 0 0 0 0 0 0 0 0 0 0 0 20 0 0 0 0 212 25 25 67 25 25 
25 25 25 25 25 25 25 25 25 25 214 0 0 0 0 0 0 0 0 0 20 0 0 0 69 0 0 114 115 116 0 0 51 13 0 11 53 0 0 0 0 0 0 0 0 0 0 0 0 0 0 0 0 0 0 0 0 0 212 25 25 25 25 25 
25 25 25 25 25 25 25 25 25 25 198 193 193 194 0 0 0 0 0 0 0 0 0 0 0 0 0 0 0 0 0 0 0 51 12 53 0 0 0 0 0 0 0 0 0 0 0 0 0 0 0 0 0 0 0 0 0 0 212 25 25 25 25 25 
25 25 25 25 25 25 25 67 25 25 25 25 25 198 193 193 194 0 0 0 0 0 0 20 0 0 0 0 0 0 0 0 0 0 50 0 0 0 0 114 115 116 0 0 0 0 0 20 0 0 0 0 0 0 20 0 0 0 212 25 25 25 25 25 
25 25 25 25 25 25 25 25 25 25 25 25 25 25 25 25 198 193 193 193 194 0 0 0 0 0 0 0 0 0 0 0 0 0 0 0 0 0 0 0 0 0 0 0 0 0 0 0 0 0 0 0 0 0 0 0 0 0 212 25 25 25 25 25 
25 25 25 25 25 25 25 25 25 25 25 25 25 25 25 25 25 25 25 25 198 193 193 193 193 193 193 193 193 193 193 193 193 193 193 193 193 193 193 194 0 0 0 0 0 0 0 0 0 0 0 0 0 0 0 0 0 0 212 25 25 25 25 25 
25 25 25 25 25 25 25 25 25 25 25 25 25 25 25 25 25 25 25 25 25 25 25 25 25 25 25 25 25 25 25 25 25 25 25 25 25 25 25 198 193 193 193 193 193 193 193 193 193 194 0 0 0 0 0 0 0 0 212 25 25 67 25 25 
25 25 25 25 25 25 25 25 25 105 25 25 25 25 25 25 25 25 25 25 25 25 25 25 25 25 25 25 25 25 25 25 25 25 25 25 25 25 25 25 25 25 25 25 25 25 25 25 25 198 193 194 0 0 0 0 0 0 212 25 25 25 25 25 
25 25 25 25 25 25 67 25 25 25 25 25 25 25 25 105 105 25 25 25 25 105 105 0 0 0 105 105 0 0 0 122 0 0 0 0 0 0 0 0 0 25 25 25 25 25 25 25 25 25 25 198 193 193 193 193 193 193 199 25 25 25 25 25 
25 25 25 25 25 25 25 25 25 25 25 105 25 105 25 25 105 105 105 25 25 105 105 105 105 105 123 105 105 105 105 0 0 105 105 105 105 105 0 0 0 0 0 0 0 0 0 0 0 25 25 25 25 25 25 25 25 25 25 25 25 25 25 25 
25 25 25 25 25 25 25 25 25 25 25 25 25 105 25 25 25 25 105 105 105 105 105 105 105 105 105 105 105 105 105 105 105 105 0 0 105 105 105 105 105 0 0 105 105 105 105 105 0 25 25 25 25 25 25 25 25 25 25 25 67 25 25 25 
25 25 25 25 25 25 67 25 25 25 25 25 105 105 25 25 105 25 105 0 0 0 0 105 105 105 105 105 105 105 105 105 0 122 105 105 105 0 0 105 105 105 0 0 0 105 105 105 105 105 105 105 25 25 25 25 25 25 25 25 25 25 25 25 
25 25 25 25 25 25 25 25 25 25 25 25 105 25 105 25 105 105 105 105 105 105 105 105 105 105 105 105 105 105 105 0 105 105 105 105 105 105 105 0 0 0 122 0 0 105 105 105 105 105 105 105 105 25 105 105 105 105 105 25 25 25 25 25 
25 25 25 25 25 25 25 25 25 25 25 25 25 25 105 25 105 105 105 105 105 105 105 105 105 105 105 105 105 105 105 105 105 105 105 105 105 105 105 105 105 105 105 0 105 105 105 105 105 105 105 105 105 105 105 105 105 105 0 105 105 25 25 25 
25 25 25 25 25 25 25 25 25 25 25 25 25 25 25 105 105 105 105 105 105 105 105 105 105 105 105 105 105 105 105 105 0 105 105 105 105 105 105 105 105 105 105 105 105 105 105 105 105 105 105 105 105 25 25 105 105 105 105 25 25 25 25 25 
25 25 25 25 25 25 25 25 25 25 25 25 25 25 25 25 25 25 25 25 25 25 25 25 25 25 25 25 25 25 25 105 105 105 105 105 105 105 105 105 105 105 105 25 105 105 105 105 105 105 105 25 25 25 25 25 25 25 105 105 25 25 25 25 
25 25 25 25 25 25 25 25 25 25 25 25 25 25 25 25 25 25 25 25 25 25 25 25 25 25 25 25 25 25 25 25 25 25 25 25 25 25 25 25 25 25 25 25 25 25 25 25 25 25 25 25 25 25 25 25 25 25 25 25 25 25 25 25
