40 40 40 40 40 40 40 40 40 40 40 40 40 40 40 40 40 40 40 40 40 40 40 40 40 40 40 40 40 40 40 40 40 40 40 40 40 40 40 40 40 40 40 40 40 40 40 40 40 40 40 40 40 40 40 40 40 40 40 40 40 40 40 40 
156 156 156 156 156 156 156 156 156 156 156 156 156 156 156 156 156 156 156 156 156 156 156 156 156 156 40 40 40 40 40 40 40 40 40 40 40 40 40 40 40 40 40 40 40 40 40 40 40 40 40 40 40 40 40 40 40 40 40 40 40 40 40 40 
156 156 156 156 156 156 156 156 156 156 156 156 156 156 156 156 156 156 156 156 156 156 156 156 156 156 156 156 156 156 156 156 40 40 40 40 40 40 40 40 40 40 40 40 40 40 40 40 40 40 40 40 40 40 40 40 40 40 40 40 40 40 40 40 
156 156 156 156 156 156 156 156 156 156 156 156 156 156 156 156 156 156 156 156 156 156 156 156 156 156 156 156 156 156 156 156 156 156 156 156 156 156 156 156 156 156 156 156 156 156 156 156 156 156 156 156 156 156 156 156 156 156 40 40 40 40 40 40 
156 156 156 156 156 156 156 156 156 156 156 156 156 156 156 156 156 156 156 156 156 156 156 156 156 156 156 156 156 156 156 156 156 156 156 156 156 156 156 156 156 156 156 156 156 156 156 156 156 156 156 156 156 156 156 156 156 156 40 40 40 40 40 40 
156 156 156 156 156 156 156 156 156 156 156 156 156 156 156 156 156 156 171 40 40 40 40 40 40 40 40 40 40 156 156 156 156 156 156 156 156 156 156 156 156 156 156 156 156 156 156 156 156 156 156 156 156 156 156 156 156 156 40 40 40 40 40 40 
40 40 40 40 40 40 40 40 40 40 40 40 40 156 156 156 156 40 40 40 40 40 40 40 40 40 40 40 40 40 40 40 40 40 40 40 40 40 40 156 156 156 40 40 40 40 40 40 40 40 40 40 40 40 40 156 156 156 40 40 40 40 40 40 
40 40 40 40 40 40 40 40 40 40 40 40 40 156 156 156 156 40 40 40 40 40 40 40 40 40 40 40 40 40 40 40 40 40 40 40 40 40 40 156 156 156 40 40 40 40 40 40 40 40 40 40 40 40 40 156 156 156 40 40 40 40 40 40 
40 40 40 40 40 40 40 40 40 40 40 40 40 156 156 156 156 40 40 40 40 40 40 40 40 40 40 40 40 40 40 40 40 40 40 40 40 40 40 156 156 156 40 40 40 40 40 40 40 40 40 40 40 40 40 156 156 156 40 40 40 40 40 40 
40 40 40 40 40 40 40 40 40 40 40 40 40 156 156 156 156 40 40 40 40 40 40 40 40 40 40 40 40 40 40 40 40 40 40 40 40 40 40 156 156 156 40 40 40 40 40 40 40 40 40 40 40 40 40 156 156 156 40 40 40 40 40 40 
40 40 40 40 40 40 40 40 40 40 40 40 40 40 156 156 156 40 40 40 40 40 40 40 40 40 40 40 40 40 40 40 40 40 40 40 40 40 40 156 156 156 40 40 40 40 40 40 40 40 40 40 40 40 40 156 156 156 40 40 40 40 40 40 
40 40 40 40 40 40 40 40 40 40 40 40 40 40 156 156 156 40 40 40 40 40 40 40 40 40 40 40 40 40 40 40 40 40 40 40 40 40 40 156 156 156 40 40 40 40 40 40 40 40 40 40 40 40 40 156 156 156 40 40 40 40 40 40 
40 40 40 40 40 40 40 40 40 40 40 40 40 40 156 156 156 40 40 40 40 40 40 40 40 40 40 40 40 40 40 40 40 40 40 40 40 40 40 156 156 156 40 40 40 40 40 40 40 40 40 40 40 40 40 156 156 156 40 40 40 40 40 40 
40 40 40 40 40 156 156 156 156 156 156 156 156 156 156 156 156 156 156 156 40 40 40 40 40 40 40 40 40 40 40 40 40 40 40 40 40 40 40 156 156 156 40 40 40 40 40 40 40 156 156 156 156 156 156 156 156 156 40 40 40 40 40 40 
40 40 40 40 40 156 156 156 156 156 156 156 156 156 156 156 156 156 156 156 156 156 40 40 40 40 40 40 40 40 40 40 40 40 40 40 40 40 40 156 156 156 40 40 40 40 40 40 156 156 156 156 156 156 156 156 156 156 40 40 40 40 40 40 
40 40 40 40 40 156 156 156 156 156 156 156 156 156 156 156 156 156 156 156 156 156 40 40 40 40 40 40 40 40 40 40 40 40 40 40 40 40 40 156 156 156 40 40 40 40 40 40 156 156 156 156 156 156 156 156 156 156 40 40 40 40 40 40 
40 40 40 40 40 156 156 156 156 156 156 156 156 156 156 156 156 156 156 156 156 156 40 40 40 40 40 40 40 40 40 40 40 40 40 40 40 40 40 156 156 156 40 40 40 40 40 40 156 156 156 156 40 156 156 156 156 156 40 40 40 40 40 40 
40 40 40 40 156 156 156 156 156 156 156 156 156 156 156 156 156 156 156 156 156 156 40 40 40 40 40 40 40 40 40 40 40 40 40 40 40 156 156 156 156 156 40 40 40 40 40 40 40 40 40 40 40 40 40 156 156 156 40 40 40 40 40 40 
40 40 40 40 156 156 156 156 156 156 156 156 156 156 156 156 156 156 156 156 156 156 40 40 40 40 40 40 40 40 40 40 40 40 40 156 156 156 156 156 156 156 40 40 40 40 40 40 40 40 40 40 40 40 40 156 156 156 40 40 40 40 40 40 
40 40 40 40 156 156 156 156 156 156 156 156 156 156 156 156 156 156 156 156 156 40 40 40 40 40 40 40 40 40 40 40 40 40 40 156 156 156 156 156 156 156 40 40 40 40 40 40 40 40 40 40 40 40 40 156 156 156 40 40 40 40 40 40 
40 40 40 40 156 156 156 156 156 156 156 156 156 156 156 156 156 156 156 156 156 40 40 40 40 40 40 40 40 40 40 40 40 40 156 156 156 156 156 156 156 156 40 40 40 40 40 40 40 40 40 40 40 40 40 156 156 156 40 40 40 40 40 40 
40 40 40 40 40 40 40 156 156 156 156 156 156 156 156 156 156 156 156 156 40 40 40 40 40 40 40 40 40 40 40 40 156 156 156 156 156 156 156 156 156 156 40 40 40 40 40 40 40 40 40 40 40 40 40 156 156 156 40 40 40 40 40 40 
40 40 40 40 40 40 40 40 156 156 156 156 156 156 156 156 156 40 40 40 40 40 40 40 40 40 40 40 40 40 40 156 156 156 156 156 156 156 156 156 156 156 40 40 40 40 40 40 40 40 40 40 40 40 40 156 156 156 40 40 40 40 40 40 
40 40 40 40 40 40 40 40 156 156 156 156 156 156 40 40 40 40 40 40 40 40 40 40 40 40 40 40 40 40 156 156 156 156 156 156 156 156 156 156 156 156 40 40 40 40 40 40 40 40 40 40 40 40 40 156 156 156 40 40 40 40 40 40 
40 40 40 40 40 40 40 40 40 40 40 40 40 40 40 40 40 40 40 40 40 40 40 40 40 40 40 40 40 156 156 156 156 156 156 156 156 156 156 156 156 156 156 40 40 40 40 40 40 40 40 40 40 40 40 156 156 156 40 40 40 40 40 40 
40 40 40 40 40 40 40 40 40 40 40 40 40 40 40 40 40 40 40 40 40 40 40 40 40 40 156 156 156 156 156 156 156 156 156 156 156 156 156 156 156 156 156 156 156 40 40 40 40 40 40 40 40 40 40 156 156 156 40 40 40 40 40 40 
40 40 40 40 40 40 40 40 40 40 40 40 40 40 40 40 40 40 40 40 40 40 40 40 156 156 156 156 156 156 156 156 156 156 156 156 156 156 156 156 156 156 156 156 156 40 40 40 40 40 40 40 40 40 40 156 156 156 40 40 40 40 40 40 
40 40 40 40 40 40 40 40 40 40 40 40 40 40 40 40 40 40 40 40 40 40 40 156 156 156 156 156 156 156 156 156 156 156 156 156 156 156 156 156 156 156 156 156 156 40 40 40 40 40 40 40 40 40 40 156 156 156 40 40 40 40 40 40 
40 40 40 40 40 40 40 40 40 40 40 40 40 40 40 40 40 40 40 40 40 156 156 156 156 156 156 156 156 156 156 156 156 156 156 156 156 156 156 156 156 156 156 156 156 40 40 40 40 40 40 40 40 40 40 156 156 156 40 40 40 40 40 40 
40 40 40 40 40 40 40 40 40 40 40 40 40 40 40 40 40 40 40 40 40 156 156 156 156 156 156 156 156 156 156 156 156 156 156 156 156 156 156 156 156 156 156 156 156 40 40 40 40 40 40 40 40 40 40 156 156 156 40 40 40 40 40 40 
40 40 40 40 40 40 40 40 40 40 40 40 40 40 40 40 40 40 40 40 40 156 156 156 156 156 156 156 156 156 156 156 156 156 156 156 156 156 156 156 156 156 156 156 156 40 40 40 40 40 40 40 40 40 40 156 156 156 40 40 40 40 40 40 
40 40 40 40 40 40 40 40 40 40 40 40 40 40 40 40 40 40 40 40 40 156 156 156 156 156 156 156 156 156 156 156 156 156 156 156 156 156 156 156 156 156 156 156 156 40 40 40 40 40 40 40 40 40 40 156 156 156 40 40 40 40 40 40 
40 40 40 40 40 40 40 40 40 40 40 40 40 40 40 40 40 40 40 40 40 40 156 156 156 156 156 156 156 156 156 156 156 156 156 156 156 156 156 156 156 156 156 156 156 40 40 40 40 40 40 40 40 40 40 156 156 156 40 40 40 40 40 40 
40 40 40 40 40 40 40 40 40 40 40 40 40 40 40 40 40 40 40 40 40 40 40 156 156 156 156 156 156 156 156 156 156 156 156 156 156 156 156 156 156 156 156 156 156 40 40 40 40 40 40 40 40 156 156 156 156 156 40 40 40 40 40 40 
40 40 40 40 40 40 40 40 156 156 156 156 40 40 40 40 40 40 40 40 40 40 40 40 156 156 156 156 156 156 156 156 156 156 156 156 156 156 156 156 156 156 156 156 156 40 40 40 40 40 40 40 156 156 156 156 156 156 40 40 40 40 40 40 
40 40 40 40 40 40 40 40 156 156 156 156 156 156 156 40 40 40 40 40 40 40 40 40 40 40 40 40 40 40 156 156 156 156 156 156 156 156 156 40 40 40 40 40 40 40 40 40 40 40 40 156 156 156 156 156 156 156 40 40 40 40 40 40 
40 40 40 40 40 40 156 156 156 156 156 156 156 156 156 156 156 40 40 40 40 40 40 40 40 40 40 40 40 40 40 40 40 40 40 40 40 40 40 40 40 40 40 40 40 40 40 40 40 40 156 156 156 156 156 156 156 156 40 40 40 40 40 40 
40 40 40 40 40 40 156 156 156 156 156 156 156 156 156 156 156 156 156 40 40 40 40 40 40 40 40 40 40 40 40 40 40 40 40 40 40 40 40 40 40 40 40 40 40 40 40 40 40 156 156 156 156 156 156 156 156 156 40 40 40 40 40 40 
40 40 40 40 40 40 156 156 156 156 156 156 156 156 156 156 156 156 156 156 156 156 40 40 40 40 40 40 40 40 40 40 40 40 40 40 40 40 40 40 40 40 40 40 40 40 40 40 156 156 156 156 156 156 40 156 156 156 40 40 40 40 40 40 
40 40 40 40 40 40 156 156 156 156 156 156 156 156 156 156 156 156 156 156 156 156 40 40 40 40 40 40 40 40 40 40 40 40 40 40 40 40 40 40 40 40 40 40 40 156 156 156 156 156 156 156 156 40 40 156 156 156 40 40 40 40 40 40 
40 40 40 40 40 40 156 156 156 156 156 156 156 156 156 156 156 156 156 156 156 156 156 40 40 40 40 40 40 40 40 40 40 40 40 40 40 40 40 40 40 40 40 40 156 156 156 156 156 156 156 156 40 40 40 156 156 156 40 40 40 40 40 40 
40 40 40 40 40 40 156 156 156 156 156 156 156 156 156 156 156 156 156 156 156 156 156 156 40 40 40 40 40 40 40 40 40 40 40 40 40 40 40 40 40 40 40 156 156 156 156 156 156 156 40 40 40 40 40 156 156 156 40 40 40 40 40 40 
40 40 40 40 40 40 156 156 156 156 156 156 156 156 156 156 156 156 156 156 156 156 156 156 156 156 40 40 40 40 40 40 40 40 40 40 40 40 156 156 156 156 156 156 156 156 156 156 40 40 40 40 40 40 40 156 156 156 40 40 40 40 40 40 
40 40 40 40 40 40 156 156 156 156 156 156 156 156 156 156 156 156 156 156 156 156 156 156 156 156 156 40 40 40 40 40 40 40 40 40 40 156 156 156 156 156 156 156 156 156 156 40 40 40 40 40 40 40 40 156 156 156 40 40 40 40 40 40 
40 40 40 40 40 40 40 156 156 156 156 156 156 156 156 156 156 156 156 156 156 156 156 156 156 156 156 40 40 40 40 40 40 156 156 156 156 156 156 156 156 156 156 156 156 156 40 40 40 40 40 40 40 40 40 156 156 156 40 40 40 40 40 40 
40 40 40 40 40 40 40 156 156 156 156 156 156 156 156 156 156 156 156 156 156 156 156 156 156 156 156 40 40 40 40 40 40 156 156 156 156 156 156 156 156 40 40 40 40 40 40 40 40 40 40 40 40 40 156 156 156 156 40 40 40 40 40 40 
40 40 40 40 40 40 156 156 156 156 156 156 156 156 156 156 156 156 156 156 156 156 156 156 156 156 156 40 40 40 156 156 156 156 156 156 156 156 156 156 40 40 40 40 40 40 40 40 40 40 40 40 40 40 156 156 156 156 40 40 40 40 40 40 
40 40 40 40 40 156 156 156 156 156 38 38 38 38 38 38 38 38 38 38 38 156 156 156 156 156 156 156 156 156 156 156 156 156 156 156 40 40 40 40 40 40 40 40 40 40 40 40 40 40 40 40 40 40 156 156 156 40 40 40 40 40 40 40 
40 40 40 40 40 156 156 156 156 156 38 38 38 38 38 38 38 38 38 38 38 38 38 156 156 156 156 156 156 156 156 156 156 156 156 156 40 40 40 40 40 40 40 40 40 40 40 40 40 40 40 40 40 40 156 156 156 40 40 40 40 40 40 40 
40 40 40 40 40 156 156 156 156 38 38 38 38 38 38 38 38 38 38 38 38 38 38 156 156 156 156 156 156 156 156 156 156 40 40 40 40 40 40 40 40 40 40 40 40 40 40 40 40 40 40 40 40 40 156 156 156 40 40 40 40 40 40 40 
40 40 40 40 156 156 156 156 156 38 38 38 38 38 38 38 38 38 38 38 38 38 38 156 156 156 156 156 156 156 156 156 40 40 40 40 40 40 40 40 40 40 40 40 40 40 40 40 40 40 40 40 40 40 156 156 156 40 40 40 40 40 40 40 
40 40 40 40 156 156 156 156 156 38 38 38 38 38 38 38 38 38 38 38 38 38 38 156 156 156 40 40 40 40 40 40 40 40 40 40 40 40 40 40 40 40 40 40 40 40 40 40 40 40 40 40 40 40 156 156 156 40 40 40 40 40 40 40 
40 40 40 40 156 156 156 156 156 38 38 38 38 38 38 38 38 38 38 38 38 38 38 156 156 40 40 40 40 40 40 40 40 40 40 40 40 40 40 40 40 40 40 40 40 40 40 40 40 40 40 40 40 40 156 156 156 40 40 40 40 40 40 40 
40 40 40 40 40 156 156 156 156 156 156 156 156 38 156 156 156 156 156 156 156 156 156 156 156 40 40 40 40 40 40 40 40 40 40 40 40 40 40 40 40 40 40 40 40 40 40 40 40 40 40 40 40 40 156 156 156 40 40 40 40 40 40 40 
40 40 40 40 40 156 156 156 156 156 156 156 156 156 156 156 156 156 156 156 156 156 156 156 156 40 40 40 40 40 156 156 156 156 156 156 156 156 156 156 156 156 156 156 156 156 156 156 156 156 156 156 156 156 156 156 156 40 40 40 40 40 40 40 
40 40 40 40 40 40 156 156 156 156 156 156 156 156 156 156 156 156 156 156 156 156 156 156 156 40 40 40 40 40 156 156 156 156 156 156 156 156 156 156 156 156 156 156 156 156 156 156 156 156 156 156 156 156 156 156 156 40 40 40 40 40 40 40 
40 40 40 40 40 40 40 40 40 40 156 156 156 156 156 156 156 156 156 156 156 156 156 156 156 40 40 40 40 40 156 156 156 156 156 156 156 156 156 156 156 156 156 156 156 156 156 156 156 156 156 156 156 156 156 156 156 40 40 40 40 40 40 40 
40 40 40 40 40 40 40 40 40 40 40 156 156 156 156 156 156 156 156 156 156 156 156 40 40 40 40 40 40 40 40 40 40 40 40 40 40 40 40 40 40 40 40 40 40 40 40 40 40 40 40 40 40 40 40 40 40 40 40 40 40 40 40 40 
40 40 40 40 40 40 40 40 40 40 40 156 156 156 156 156 156 156 156 156 156 156 156 40 40 40 40 40 40 40 40 40 40 40 40 40 40 40 40 40 40 40 40 40 40 40 40 40 40 40 40 40 40 40 40 40 40 40 40 40 40 40 40 40 
40 40 40 40 40 40 40 40 40 40 40 40 40 40 40 156 156 156 156 156 156 156 156 40 40 40 40 40 40 40 40 40 40 40 40 40 40 40 40 40 40 40 40 40 40 40 40 40 40 40 40 40 40 40 40 40 40 40 40 40 40 40 40 40 
40 40 40 40 40 40 40 40 40 40 40 40 40 40 40 40 40 40 40 156 156 156 156 40 40 40 40 40 40 40 40 40 40 40 40 40 40 40 40 40 40 40 40 40 40 40 40 40 40 40 40 40 40 40 40 40 40 40 40 40 40 40 40 40 
40 40 40 40 40 40 40 40 40 40 40 40 40 40 40 40 40 40 40 40 40 40 40 40 40 40 40 40 40 40 40 40 40 40 40 40 40 40 40 40 40 40 40 40 40 40 40 40 40 40 40 40 40 40 40 40 40 40 40 40 40 40 40 40 
40 40 40 40 40 40 40 40 40 40 40 40 40 40 40 40 40 40 40 40 40 40 40 40 40 40 40 40 40 40 40 40 40 40 40 40 40 40 40 40 40 40 40 40 40 40 40 40 40 40 40 40 40 40 40 40 40 40 40 40 40 40 40 40 
40 40 40 40 40 40 40 40 40 40 40 40 40 40 40 40 40 40 40 40 40 40 40 40 40 40 40 40 40 40 40 40 40 40 40 40 40 40 40 40 40 40 40 40 40 40 40 40 40 40 40 40 40 40 40 40 40 40 40 40 40 40 40 40