40 40 40 40 40 40 40 40 40 40 40 40 40 40 40 40 40 40 40 40 40 40 40 40 40 40 40 40 40 40 40 40 40 40 40 40 40 40 40 40 40 40 40 40 40 40 40 40 40 40 40 40 40 40 40 40 40 40 40 40 40 40 40 40 
250 250 250 250 250 250 250 250 250 250 250 250 250 250 250 250 250 250 250 250 250 250 250 250 250 250 40 40 40 40 40 40 40 40 40 40 40 40 40 40 40 40 40 40 40 40 40 40 40 40 40 40 40 40 40 40 40 40 40 40 40 40 40 40 
250 250 250 250 250 250 250 250 250 250 250 250 250 250 250 250 250 250 250 250 250 250 250 250 250 250 250 250 250 250 250 250 40 40 40 40 40 40 40 40 40 40 40 40 40 40 40 40 40 40 40 40 40 40 40 40 40 40 40 40 40 40 40 40 
250 250 250 250 250 250 250 250 250 250 250 250 250 250 250 250 250 250 250 250 250 250 250 250 250 250 250 250 250 250 250 250 250 250 250 250 250 250 250 250 250 250 250 250 250 250 250 250 250 250 250 250 250 250 250 250 250 250 40 40 40 40 40 40 
250 250 250 250 250 250 250 250 250 250 250 250 250 250 250 250 250 250 250 250 250 250 250 250 250 250 250 250 250 250 250 250 250 250 250 250 250 250 250 250 250 250 250 250 250 250 250 250 250 250 250 250 250 250 250 250 250 250 40 40 40 40 40 40 
250 250 250 250 250 250 250 250 250 250 250 250 250 250 250 250 250 250 250 40 40 40 40 40 40 40 40 40 40 250 250 250 250 250 250 250 250 250 250 250 250 250 250 250 250 250 250 250 250 250 250 250 250 250 250 250 250 250 40 40 40 40 40 40 
40 40 303 303 303 303 303 303 303 303 303 303 303 250 250 250 250 40 40 40 40 40 40 40 40 40 40 40 40 40 40 40 40 40 40 40 40 40 40 250 250 250 40 40 40 40 40 40 40 40 40 40 40 40 40 250 250 250 40 40 40 40 40 40 
40 40 40 40 40 40 40 40 40 40 40 40 40 250 250 250 250 40 40 40 40 40 40 40 40 40 40 40 40 40 40 40 40 40 40 40 40 40 40 250 250 250 40 40 40 40 40 40 40 40 40 40 40 40 40 250 250 250 40 40 40 40 40 40 
40 40 40 40 40 40 40 40 40 40 40 40 40 250 250 250 250 40 40 40 40 40 40 40 40 40 40 40 40 40 40 40 40 40 40 40 40 40 40 250 250 250 40 40 40 40 40 40 40 40 40 40 40 40 40 250 250 250 40 40 40 40 40 40 
40 40 40 40 40 40 40 40 40 40 40 40 40 250 250 250 250 40 40 40 40 40 40 40 40 40 40 40 40 40 40 40 40 40 40 40 40 40 40 250 250 250 40 40 40 40 40 40 40 40 40 40 40 40 40 250 250 250 40 40 40 40 40 40 
40 40 40 40 40 40 40 40 40 40 40 40 40 40 250 250 250 40 40 40 40 40 40 40 40 40 40 40 40 40 40 40 40 40 40 40 40 40 40 250 250 250 40 40 40 40 40 40 40 40 40 40 40 40 40 250 250 250 40 40 40 40 40 40 
40 40 40 40 40 40 40 40 40 40 40 40 40 40 250 250 250 40 40 40 40 40 40 40 40 40 40 40 40 40 40 40 40 40 40 40 40 40 40 250 250 250 40 40 40 40 40 40 40 40 40 40 40 40 40 250 250 250 40 40 40 40 40 40 
40 40 40 40 40 40 40 40 40 40 40 40 40 40 250 250 250 40 40 40 40 40 40 40 40 40 40 40 40 40 40 40 40 40 40 40 40 40 40 250 250 250 40 40 40 40 40 40 40 40 40 40 40 40 40 250 250 250 40 40 40 40 40 40 
40 40 40 40 40 250 250 250 250 250 250 250 250 250 250 250 250 250 250 250 40 40 40 40 40 40 40 40 40 40 40 40 40 40 40 40 40 40 40 250 250 250 40 40 40 40 40 40 40 250 250 250 250 250 250 250 250 250 40 40 40 40 40 40 
40 40 40 40 40 250 250 250 250 250 250 250 250 250 250 250 250 250 250 250 250 250 40 40 40 40 40 40 40 40 40 40 40 40 40 40 40 40 40 250 250 250 40 40 40 40 40 40 250 250 250 250 250 250 250 250 250 250 40 40 40 40 40 40 
40 40 40 40 40 250 250 250 250 250 250 250 250 250 250 250 250 250 250 250 250 250 40 40 40 40 40 40 40 40 40 40 40 40 40 40 40 40 40 250 250 250 40 40 40 40 40 40 250 250 250 250 250 250 250 250 250 250 40 40 40 40 40 40 
40 40 40 40 40 250 250 250 250 250 250 250 250 250 250 250 250 250 250 250 250 250 40 40 40 40 40 40 40 40 40 40 40 40 40 40 40 40 40 250 250 250 40 40 40 40 40 40 250 250 250 250 40 250 250 250 250 250 40 40 40 40 40 40 
40 40 40 40 250 250 250 250 250 250 250 250 250 250 250 250 250 250 250 250 250 250 40 40 40 40 40 40 40 40 40 40 40 40 40 40 40 250 250 250 250 250 40 40 40 40 40 40 40 40 40 40 40 40 40 250 250 250 40 40 40 40 40 40 
40 40 40 40 250 250 250 250 250 250 250 250 250 250 250 250 250 250 250 250 250 250 40 40 40 40 40 40 40 40 40 40 40 40 40 250 250 250 250 250 250 250 40 40 40 40 40 40 40 40 40 40 40 40 40 250 250 250 40 40 40 40 40 40 
40 40 40 40 250 250 250 250 250 250 250 250 250 250 250 250 250 250 250 250 250 40 40 40 40 40 40 40 40 40 40 40 40 40 40 250 250 250 250 250 250 250 40 40 40 40 40 40 40 40 40 40 40 40 40 250 250 250 40 40 40 40 40 40 
40 40 40 40 250 250 250 250 250 250 250 250 250 250 250 250 250 250 250 250 250 40 40 40 40 40 40 40 40 40 40 40 40 40 250 250 250 250 250 250 250 250 40 40 40 40 40 40 40 40 40 40 40 40 40 250 250 250 40 40 40 40 40 40 
40 40 40 40 40 40 40 250 250 187 189 250 250 250 250 250 250 250 250 250 40 40 40 40 40 40 40 40 40 40 40 40 250 250 250 250 250 250 250 250 250 250 40 40 40 40 40 40 40 40 40 40 40 40 40 250 250 250 40 40 40 40 40 40 
40 40 40 40 40 40 40 40 250 227 229 250 250 250 250 250 250 40 40 40 40 40 40 40 40 40 40 40 40 40 40 250 250 250 250 250 250 250 250 250 250 250 40 40 40 40 40 40 40 40 40 40 40 40 40 250 250 250 40 40 40 40 40 40 
40 40 40 40 40 40 40 40 250 250 250 250 250 250 40 40 40 40 40 40 40 40 40 40 40 40 40 40 40 40 250 250 250 250 250 250 250 250 250 250 250 250 40 40 40 40 40 40 40 40 40 40 40 40 40 250 250 250 40 40 40 40 40 40 
40 40 40 40 40 40 40 40 40 40 40 40 40 40 40 40 40 40 40 40 40 40 40 40 40 40 40 40 40 250 250 250 250 250 250 250 250 250 250 250 250 250 250 40 40 40 40 40 40 40 40 40 40 40 40 250 250 250 40 40 40 40 40 40 
40 40 40 40 40 40 40 40 40 40 40 40 40 40 40 40 40 40 40 40 40 40 40 40 40 40 250 250 250 250 250 250 250 250 250 250 250 250 250 250 250 250 250 250 250 40 40 40 40 40 40 40 40 40 40 250 250 250 40 40 40 40 40 40 
40 40 40 40 40 40 40 40 40 40 40 40 40 40 40 40 40 40 40 40 40 40 40 40 250 250 250 250 250 250 250 250 250 250 250 250 250 250 187 189 250 250 250 250 250 40 40 40 40 40 40 40 40 40 40 250 250 250 40 40 40 40 40 40 
40 40 40 40 40 40 40 40 40 40 40 40 40 40 40 40 40 40 40 40 40 40 40 250 250 250 250 250 250 250 250 0 0 250 250 250 250 250 227 229 250 187 189 250 250 40 40 40 40 40 40 40 40 40 40 250 250 250 40 40 40 40 40 40 
40 40 40 40 40 40 40 40 40 40 40 40 40 40 40 40 40 40 40 40 40 250 250 250 250 250 250 250 250 250 0 0 0 250 250 250 250 250 187 189 250 227 229 250 250 40 40 40 40 40 40 40 40 40 40 250 250 250 40 40 40 40 40 40 
40 40 40 40 40 40 40 40 40 40 40 40 40 40 40 40 40 40 40 40 40 250 250 250 250 250 250 250 250 250 0 0 250 250 250 250 250 187 291 209 250 250 250 250 250 40 40 40 40 40 40 40 40 40 40 250 250 250 40 40 40 40 40 40 
40 40 40 40 40 40 40 40 40 40 40 40 40 40 40 40 40 40 40 40 40 250 250 250 250 250 250 250 250 250 0 250 250 250 250 250 250 207 208 209 250 250 250 250 250 40 40 40 40 40 40 40 40 40 40 250 250 250 40 40 40 40 40 40 
40 40 40 40 40 40 40 40 40 40 40 40 40 40 40 40 40 40 40 40 40 250 250 250 250 250 250 250 250 250 250 250 250 250 250 250 250 227 228 229 250 250 250 250 250 40 40 40 40 40 40 40 40 40 40 250 250 250 40 40 40 40 40 40 
40 40 40 40 40 40 40 40 40 40 40 40 40 40 40 40 40 40 40 40 40 40 250 250 250 250 250 250 250 250 250 250 250 250 250 250 250 250 250 250 250 250 250 250 250 40 40 40 40 40 40 40 40 40 40 250 250 250 40 40 40 40 40 40 
40 40 40 40 40 40 40 40 40 40 40 40 40 40 40 40 40 40 40 40 40 40 40 250 250 250 250 250 250 250 250 250 250 250 250 250 250 250 250 250 250 250 250 250 250 40 40 40 40 40 40 40 40 250 250 250 250 250 40 40 40 40 40 40 
40 40 40 40 40 40 40 40 250 250 250 250 40 40 40 40 40 40 40 40 40 40 40 40 250 250 250 250 250 250 250 250 250 250 250 250 250 250 250 250 250 250 250 250 250 40 40 40 40 40 40 40 250 250 250 250 250 250 40 40 40 40 40 40 
40 40 40 40 40 40 40 40 250 250 250 250 250 250 250 40 40 40 40 40 40 40 40 40 40 40 40 40 40 40 250 250 250 250 250 250 250 250 250 40 40 40 40 40 40 40 40 40 40 40 40 250 250 250 250 187 189 250 40 40 40 40 40 40 
40 40 40 40 40 40 250 250 250 250 250 250 250 250 250 250 250 40 40 40 40 40 40 40 40 40 40 40 40 40 40 40 40 40 40 40 40 40 40 40 40 40 40 40 40 40 40 40 40 40 250 250 250 250 250 227 229 250 40 40 40 40 40 40 
40 40 40 40 40 40 250 250 250 250 250 250 250 250 250 250 250 250 250 40 40 40 40 40 40 40 40 40 40 40 40 40 40 40 40 40 40 40 40 40 40 40 40 40 40 40 40 40 40 250 250 250 250 250 250 250 250 250 40 40 40 40 40 40 
40 40 40 40 40 40 250 250 250 250 250 187 189 250 250 250 250 250 250 250 250 250 40 40 40 40 40 40 40 40 40 40 40 40 40 40 40 40 40 40 40 40 40 40 40 40 40 40 250 250 250 250 250 250 40 250 250 250 40 40 40 40 40 40 
40 40 40 40 40 40 250 250 250 250 187 291 209 250 250 250 250 250 250 250 250 250 40 40 40 40 40 40 40 40 40 40 40 40 40 40 40 40 40 40 40 40 40 40 40 250 250 250 250 250 250 250 250 40 40 250 250 250 40 40 40 40 40 40 
40 40 40 40 40 40 250 250 250 250 207 208 209 187 188 188 188 188 189 250 250 250 250 40 40 40 40 40 40 40 40 40 40 40 40 40 40 40 40 40 40 40 40 40 250 250 250 250 250 250 250 250 40 40 40 250 250 250 40 40 40 40 40 40 
40 40 40 40 40 40 250 250 250 250 227 228 229 207 208 208 208 208 209 250 250 250 250 250 40 40 40 40 40 40 40 40 40 40 40 40 40 40 40 40 40 40 40 250 250 250 250 250 250 250 40 40 40 40 40 250 250 250 40 40 40 40 40 40 
40 40 40 40 40 40 250 250 250 250 250 250 187 291 208 208 208 208 209 250 250 250 250 250 250 250 40 40 40 40 40 40 40 40 40 40 40 40 250 250 250 250 250 250 250 250 250 250 40 40 40 40 40 40 40 250 250 250 40 40 40 40 40 40 
40 40 40 40 40 40 250 250 250 250 250 250 227 271 208 270 271 208 209 250 250 250 250 250 250 250 250 40 40 40 40 40 40 40 40 40 40 250 250 250 250 250 250 250 250 250 250 40 40 40 40 40 40 40 40 250 250 250 40 40 40 40 40 40 
40 40 40 40 40 40 40 250 250 250 250 250 250 227 228 229 227 228 229 250 250 250 250 250 250 250 250 40 40 40 40 40 40 250 250 250 250 250 250 250 250 250 250 250 250 250 40 40 40 40 40 40 40 40 40 250 250 250 40 40 40 40 40 40 
40 40 40 40 40 40 40 250 250 250 250 250 250 250 250 250 250 250 250 250 250 250 250 250 250 250 250 40 40 40 40 40 40 250 250 250 250 250 250 250 250 40 40 40 40 40 40 40 40 40 40 40 40 40 250 250 250 250 40 40 40 40 40 40 
40 40 40 40 40 40 250 250 250 250 250 250 250 250 250 250 250 250 250 250 250 250 250 250 250 250 250 40 40 40 250 250 250 250 250 250 250 250 250 250 40 40 40 40 40 40 40 40 40 40 40 40 40 40 250 250 250 250 40 40 40 40 40 40 
40 40 40 40 40 250 250 250 250 250 40 40 40 40 40 40 40 40 40 40 40 250 250 250 250 250 250 250 250 250 250 250 250 250 250 250 40 40 40 40 40 40 40 40 40 40 40 40 40 40 40 40 40 40 250 250 250 40 40 40 40 40 40 40 
40 40 40 40 40 250 250 250 250 250 40 40 40 40 40 40 40 40 40 40 40 40 40 250 250 250 250 250 250 250 250 250 250 250 250 250 40 40 40 40 40 40 40 40 40 40 40 40 40 40 40 40 40 40 250 250 250 40 40 40 40 40 40 40 
40 40 40 40 40 250 250 250 250 40 40 40 40 40 40 40 40 40 40 40 40 40 40 250 250 250 250 250 250 250 250 250 250 40 40 40 40 40 40 40 40 40 40 40 40 40 40 40 40 40 40 40 40 40 250 250 250 40 40 40 40 40 40 40 
40 40 40 40 250 250 250 250 250 40 40 40 40 40 40 40 40 40 40 40 40 40 40 250 250 250 250 250 250 250 250 250 40 40 40 40 40 40 40 40 40 40 40 40 40 40 40 40 40 40 40 40 40 40 250 250 250 40 40 40 40 40 40 40 
40 40 40 40 250 250 250 250 250 40 40 40 40 40 40 40 40 40 40 40 40 40 40 250 250 250 40 40 40 40 40 40 40 40 40 40 40 40 40 40 40 40 40 40 40 40 40 40 40 40 40 40 40 40 250 250 250 40 40 40 40 40 40 40 
40 40 40 40 250 250 250 250 250 40 40 40 40 40 40 40 40 40 40 40 40 40 40 250 250 40 40 40 40 40 40 40 40 40 40 40 40 40 40 40 40 40 40 40 40 40 40 40 40 40 40 40 40 40 250 250 250 40 40 40 40 40 40 40 
40 40 40 40 40 250 250 250 250 250 250 250 250 40 250 250 250 250 250 250 250 250 250 250 250 40 40 40 40 40 40 40 40 40 40 40 40 40 40 40 40 40 40 40 40 40 40 40 40 40 40 40 40 40 250 250 250 40 40 40 40 40 40 40 
40 40 40 40 40 250 250 250 250 250 250 250 250 250 250 250 250 250 250 250 250 250 250 250 250 40 40 40 40 40 250 250 250 250 250 250 250 250 250 250 250 250 250 250 250 250 250 250 250 250 250 250 250 250 250 250 250 40 40 40 40 40 40 40 
40 40 40 40 40 40 250 250 250 250 250 250 250 250 250 250 250 187 189 250 250 250 250 250 250 40 40 40 40 40 250 250 250 250 250 250 250 250 250 250 250 250 250 250 250 250 250 250 250 250 250 250 250 250 250 250 250 40 40 40 40 40 40 40 
40 40 40 40 40 40 40 40 40 40 250 250 250 250 250 250 250 227 229 250 250 250 250 250 250 40 40 40 40 40 250 250 250 250 250 250 250 250 250 250 250 250 250 250 250 250 250 250 250 250 250 250 250 250 250 250 250 40 40 40 40 40 40 40 
40 40 40 40 40 40 40 40 40 40 40 250 250 250 250 250 250 250 250 250 250 250 250 40 40 40 40 40 40 40 40 40 40 40 40 40 40 40 40 40 40 40 40 40 40 40 40 40 40 40 40 40 40 40 40 40 40 40 40 40 40 40 40 40 
40 40 40 40 40 40 40 40 40 40 40 250 250 250 250 250 250 250 250 250 250 250 250 40 40 40 40 40 40 40 40 40 40 40 40 40 40 40 40 40 40 40 40 40 40 40 40 40 40 40 40 40 40 40 40 40 40 40 40 40 40 40 40 40 
40 40 40 40 40 40 40 40 40 40 40 40 40 40 40 250 250 250 250 250 250 250 250 40 40 40 40 40 40 40 40 40 40 40 40 40 40 40 40 40 40 40 40 40 40 40 40 40 40 40 40 40 40 40 40 40 40 40 40 40 40 40 40 40 
40 40 40 40 40 40 40 40 40 40 40 40 40 40 40 40 40 40 40 250 250 250 250 40 40 40 40 40 40 40 40 40 40 40 40 40 40 40 40 40 40 40 40 40 40 40 40 40 40 40 40 40 40 40 40 40 40 40 40 40 40 40 40 40 
40 40 40 40 40 40 40 40 40 40 40 40 40 40 40 40 40 40 40 40 40 40 40 40 40 40 40 40 40 40 40 40 40 40 40 40 40 40 40 40 40 40 40 40 40 40 40 40 40 40 40 40 40 40 40 40 40 40 40 40 40 40 40 40 
40 40 40 40 40 40 40 40 40 40 40 40 40 40 40 40 40 40 40 40 40 40 40 40 40 40 40 40 40 40 40 40 40 40 40 40 40 40 40 40 40 40 40 40 40 40 40 40 40 40 40 40 40 40 40 40 40 40 40 40 40 40 40 40 
40 40 40 40 40 40 40 40 40 40 40 40 40 40 40 40 40 40 40 40 40 40 40 40 40 40 40 40 40 40 40 40 40 40 40 40 40 40 40 40 40 40 40 40 40 40 40 40 40 40 40 40 40 40 40 40 40 40 40 40 40 40 40 40