283 283 283 283 283 283 283 283 283 283 283 283 283 283 283 283 283 283 283 283 283 283 283 283 283 283 283 283 283 283 283 283 283 283 283 283 283 283 283 283 283 283 283 283 283 283 283 283 283 283 283 283 283 283 283 283 283 283 283 283 283 283 283 40 
282 283 303 303 303 303 303 303 303 303 303 303 303 303 303 303 303 303 303 303 303 303 303 303 303 303 303 303 303 303 303 303 283 283 283 283 283 283 283 283 283 283 283 283 283 283 283 283 283 283 283 283 283 283 283 283 283 283 283 283 283 283 283 40 
282 284 0 0 0 0 0 0 0 0 0 0 0 0 0 0 0 0 0 0 0 0 0 0 0 0 0 0 0 0 0 0 302 303 303 303 303 303 303 303 303 303 303 303 303 303 303 303 303 303 303 303 303 303 303 303 303 303 283 40 283 283 40 40 
282 284 0 0 0 0 0 0 0 0 0 0 0 0 0 0 0 0 0 0 0 0 0 0 0 0 0 205 203 206 0 0 0 0 0 0 0 0 0 0 0 0 0 0 0 0 0 0 0 0 0 0 0 0 0 0 0 0 282 40 283 283 40 40 
282 284 0 0 0 0 0 0 0 0 0 0 0 0 0 0 0 0 205 203 203 203 203 203 203 203 203 244 283 222 0 0 0 0 0 0 0 0 0 0 0 0 0 0 0 0 0 0 0 0 0 0 0 0 0 0 0 0 282 40 40 283 40 40 
282 283 203 203 203 203 203 203 203 203 203 203 203 204 0 0 0 202 244 283 283 283 283 283 283 283 283 283 40 242 263 263 263 263 263 263 263 263 264 0 0 0 262 263 263 263 263 263 263 263 263 263 263 263 264 0 0 0 282 40 283 283 40 40 
282 283 303 303 303 303 303 303 303 303 303 303 303 284 0 0 0 282 283 40 40 40 40 40 40 40 40 40 40 283 283 283 283 283 283 283 283 283 284 0 0 0 282 283 283 283 283 283 283 283 283 283 283 283 284 0 0 0 282 40 283 40 40 40 
282 283 283 283 40 40 40 40 40 40 40 40 40 284 0 0 0 282 40 40 40 40 40 40 40 40 40 40 40 40 40 40 40 40 40 40 40 40 284 0 0 0 282 40 40 40 40 40 40 40 40 40 40 40 284 0 0 0 282 40 283 283 40 40 
282 283 283 283 283 283 283 40 40 40 40 40 40 284 0 0 0 282 40 40 40 40 40 40 40 40 40 40 40 40 40 40 40 40 40 40 40 40 284 0 0 0 282 40 40 40 40 40 40 40 40 40 40 40 284 0 0 0 282 40 40 283 40 40 
282 40 283 283 283 283 283 283 283 283 40 40 40 284 0 0 0 282 40 40 40 40 40 40 40 40 40 40 40 40 40 40 40 40 40 40 40 40 284 0 0 0 282 40 40 40 40 40 40 40 40 40 40 40 284 0 0 0 282 40 40 283 40 40 
282 40 283 283 40 283 283 283 40 283 283 40 40 284 0 0 0 282 40 40 40 40 40 40 40 40 40 40 40 40 40 40 40 40 40 40 40 40 284 0 0 0 282 40 40 40 40 40 40 40 40 40 40 40 284 0 0 0 282 40 40 283 40 40 
282 40 283 40 40 40 40 40 40 40 40 40 40 284 0 0 0 282 40 40 40 40 40 40 40 40 40 40 40 40 40 40 40 40 40 40 40 40 284 0 0 0 282 40 40 40 40 40 40 40 40 40 40 40 284 0 0 0 282 40 40 283 40 40 
282 283 283 40 283 303 303 303 303 303 303 303 303 304 0 0 0 301 303 303 283 40 40 40 40 40 40 40 40 40 40 40 40 40 40 40 40 40 284 0 0 0 282 40 40 40 40 40 283 303 303 303 303 303 304 0 0 0 282 40 40 283 283 40 
282 40 40 40 284 0 0 0 0 0 0 0 0 0 0 0 0 0 0 0 302 303 283 40 40 40 40 40 40 40 40 40 40 40 40 40 40 40 284 0 0 0 282 40 40 40 40 283 304 0 0 0 0 0 0 0 0 0 282 40 40 283 283 40 
282 40 40 40 284 0 0 0 0 0 0 0 0 0 0 0 0 0 0 0 0 224 282 40 40 40 40 40 40 40 40 40 40 40 40 40 40 40 284 0 0 0 282 40 40 40 40 284 222 0 0 0 0 0 0 0 0 0 282 40 40 283 283 40 
282 40 40 40 284 0 0 0 0 0 0 255 256 256 256 257 0 0 0 0 0 224 282 40 40 40 40 40 40 40 40 40 40 40 40 40 40 40 284 0 0 0 282 40 40 40 40 284 222 0 0 0 201 0 0 0 0 0 282 40 283 283 40 40 
282 40 40 283 304 0 0 0 0 255 256 279 276 276 276 277 0 0 0 0 0 224 282 40 40 40 40 40 40 40 40 40 40 40 40 40 283 303 304 0 0 0 282 40 40 40 40 284 242 263 263 263 221 243 204 0 0 0 282 40 283 40 40 40 
282 40 40 284 222 0 0 0 255 279 276 276 276 276 276 278 257 0 0 0 0 224 282 40 40 40 40 40 40 40 40 40 40 283 283 303 304 0 0 0 0 0 282 40 40 40 40 283 283 283 283 283 283 283 284 0 0 0 282 283 283 40 40 40 
282 40 40 284 222 0 0 0 295 296 259 276 276 276 276 258 297 0 0 0 205 244 282 40 40 40 40 40 40 40 40 40 40 283 284 0 0 0 0 0 0 0 282 40 40 40 40 40 40 40 40 40 40 40 284 0 0 0 282 40 40 40 40 40 
282 40 40 284 222 0 0 0 0 0 295 296 296 296 296 297 0 0 0 0 224 283 283 40 40 40 40 40 40 40 40 40 40 283 304 0 0 0 0 0 0 0 282 40 40 40 40 40 40 40 40 40 40 40 284 0 0 0 282 283 283 40 40 40 
282 40 40 284 242 263 263 206 0 0 0 0 0 0 0 0 0 0 0 205 244 283 40 40 40 40 40 40 40 40 40 283 303 304 0 0 0 0 0 0 0 0 282 40 40 40 40 40 40 40 40 40 40 40 284 0 0 0 282 40 283 283 40 40 
282 40 40 283 283 283 283 242 206 0 0 0 0 0 0 0 205 203 203 244 283 283 40 40 40 40 40 40 40 283 283 304 0 0 0 0 0 0 0 0 0 0 282 40 40 40 40 40 40 40 40 40 40 40 284 0 0 0 282 40 40 283 283 40 
282 40 40 40 40 40 283 283 222 0 0 0 0 205 203 203 244 283 283 283 283 40 40 40 40 40 40 40 40 283 304 0 0 0 0 0 0 0 0 0 0 0 282 40 40 40 40 40 40 40 40 40 40 40 284 0 0 0 282 40 40 283 283 40 
282 40 40 40 40 40 40 283 242 203 203 203 203 244 283 283 283 283 40 40 40 40 40 40 40 40 40 40 283 304 0 0 0 0 0 255 257 0 0 0 0 0 302 283 40 40 40 40 40 40 40 40 40 40 284 0 0 0 282 40 40 283 283 40 
282 40 40 40 40 40 40 283 283 283 283 283 283 283 283 40 40 40 40 40 40 40 40 40 40 283 303 303 304 0 0 0 0 0 255 279 277 0 0 0 0 0 0 302 303 283 40 40 40 40 40 40 40 40 284 0 0 0 282 40 40 283 40 40 
282 40 40 40 40 40 40 40 40 40 40 40 40 40 40 40 40 40 40 40 40 40 40 283 303 304 0 0 0 0 0 0 0 255 279 258 297 0 0 0 0 0 0 0 224 283 40 40 40 40 40 40 40 40 284 0 0 0 282 40 40 283 40 40 
282 40 40 40 40 40 40 40 40 40 40 40 40 40 40 40 40 40 40 40 40 40 283 304 0 0 0 0 0 0 0 0 255 279 258 297 0 0 0 0 0 0 0 0 224 283 40 40 40 40 40 40 40 40 284 0 0 0 282 40 40 283 40 40 
282 40 40 40 40 40 40 40 40 40 40 40 40 40 40 40 40 40 40 40 283 303 304 0 0 0 0 0 0 0 0 255 279 258 297 0 0 0 0 0 0 0 0 0 224 283 40 40 40 40 40 40 40 40 284 0 0 0 282 40 40 283 40 40 
282 40 40 40 40 40 40 40 283 283 283 40 40 40 40 40 40 40 40 40 284 222 0 0 0 0 0 0 0 0 255 279 258 297 0 0 0 0 0 0 0 0 0 0 224 283 40 40 40 283 283 283 40 40 284 0 0 0 282 40 40 283 40 40 
282 40 40 40 40 40 283 283 283 283 283 283 283 283 283 283 40 40 40 40 284 222 0 0 0 0 0 0 255 256 279 258 297 0 0 0 0 0 0 0 0 0 0 0 224 283 40 40 40 40 283 283 40 40 284 0 0 0 282 40 40 283 40 40 
282 40 40 283 283 283 283 40 40 40 40 40 40 40 40 40 40 40 40 40 284 222 0 0 0 0 0 255 279 258 296 297 0 0 0 0 0 0 0 0 0 0 0 0 224 283 40 40 40 40 40 283 40 40 284 0 0 0 282 40 40 283 40 40 
282 40 283 283 40 283 40 40 40 40 40 40 40 40 40 40 40 40 40 40 284 242 206 0 0 0 0 295 296 297 0 0 0 0 0 0 0 0 0 0 0 0 0 0 224 283 40 40 40 40 40 40 40 40 284 0 0 0 282 40 40 283 40 40 
282 283 283 40 40 40 40 40 40 40 40 40 40 40 40 40 40 40 40 40 283 283 242 206 0 0 0 0 0 0 0 0 0 0 0 0 0 0 0 0 0 0 0 0 224 283 40 40 40 40 40 40 283 303 304 0 0 0 282 40 40 283 40 40 
282 283 40 40 40 40 40 283 303 303 303 303 283 40 40 40 40 40 40 40 40 283 283 242 206 0 0 0 0 0 0 0 0 0 0 0 0 250 0 0 0 0 0 0 224 283 40 40 40 40 40 283 304 0 0 0 0 0 282 40 40 283 40 40 
282 40 40 40 40 40 40 284 0 0 0 0 302 303 303 40 40 40 40 40 40 40 283 283 242 203 203 203 203 203 206 0 0 0 0 0 0 0 205 263 263 263 263 263 244 283 40 40 40 40 283 304 0 0 0 0 0 0 282 40 40 283 40 40 
282 40 40 40 40 283 303 304 0 0 0 0 0 0 0 302 303 283 40 40 40 40 40 283 283 283 283 283 283 283 242 243 243 243 243 243 243 243 244 283 283 283 283 283 283 283 40 40 40 283 304 0 0 0 0 0 0 0 282 40 40 283 40 40 
282 40 40 40 40 284 0 0 0 0 0 0 0 0 0 0 0 302 303 283 40 40 40 40 40 40 283 283 283 283 283 283 283 283 283 283 283 283 283 283 40 40 40 40 40 40 40 40 283 304 0 0 0 0 0 0 0 0 282 40 283 283 40 40 
282 40 40 40 40 284 0 0 0 0 0 0 0 0 0 0 0 0 0 302 303 303 283 40 40 40 40 40 40 40 40 40 40 40 40 40 40 40 40 40 40 40 40 40 40 40 40 283 304 0 0 0 205 262 264 0 0 0 282 40 283 40 40 40 
282 40 40 40 40 284 0 0 0 0 0 0 0 0 0 0 0 0 0 0 0 0 282 40 40 40 40 40 40 40 40 40 40 40 40 40 40 40 40 40 40 40 40 40 283 303 303 304 0 0 0 0 224 282 284 0 0 0 282 40 283 283 40 40 
282 40 40 40 40 284 0 0 0 0 0 0 0 0 0 0 0 0 0 0 0 0 302 283 283 40 40 40 40 40 40 40 40 40 40 40 40 40 40 40 40 40 40 283 304 0 0 0 0 0 0 205 244 282 284 0 0 0 282 40 40 283 40 40 
282 40 40 40 40 284 0 0 0 0 0 0 0 0 0 0 0 0 0 0 0 0 0 302 283 40 40 40 40 40 40 40 40 40 40 40 40 40 40 40 40 40 283 304 0 0 0 0 0 205 203 244 283 283 284 0 0 0 282 283 283 283 283 283 
282 40 40 40 40 284 0 0 0 0 0 0 0 0 0 0 0 0 0 0 0 0 0 0 302 303 283 40 40 40 40 40 40 40 40 40 40 283 303 303 303 303 304 0 0 0 0 205 203 244 283 283 283 283 284 0 0 0 282 40 40 40 283 283 
282 40 40 40 40 284 0 0 0 0 0 0 0 0 0 0 0 0 0 0 0 0 0 0 0 0 302 283 40 40 40 40 40 40 40 40 283 304 0 0 0 0 0 0 0 0 205 244 283 283 283 283 283 283 284 0 0 0 282 40 40 40 40 283 
282 40 40 40 40 284 264 0 0 0 0 0 0 0 0 0 0 0 0 0 0 0 0 0 0 0 0 282 40 40 40 40 283 303 303 303 304 0 0 0 0 0 0 0 0 205 244 283 283 283 40 40 40 40 284 0 0 0 282 40 40 40 40 283 
282 40 40 40 283 283 284 0 0 0 0 0 0 0 0 0 0 0 0 0 0 0 0 0 0 0 0 282 40 40 40 40 284 0 0 0 0 0 0 0 205 203 203 203 203 244 283 283 283 283 40 40 40 283 304 0 0 0 282 40 40 40 40 283 
282 40 40 40 40 283 304 0 0 0 0 0 0 0 0 0 0 0 0 0 0 0 0 0 0 0 0 282 40 283 303 303 304 0 0 0 0 0 0 205 244 283 283 283 283 283 283 40 40 40 40 40 40 284 0 0 0 0 282 40 40 40 40 283 
282 40 40 40 284 304 0 0 0 205 203 203 203 203 203 203 203 203 203 203 203 206 0 0 0 0 0 302 303 304 0 0 0 0 0 205 203 203 203 244 283 283 40 40 40 40 40 40 40 40 40 40 40 284 0 0 0 262 282 40 40 40 40 283 
282 283 283 283 284 0 0 0 0 224 283 283 283 283 283 283 283 283 283 283 283 242 264 0 0 0 0 0 0 0 0 0 0 0 0 224 283 283 283 283 283 40 40 40 40 40 40 40 40 40 40 40 40 284 0 0 0 282 283 40 40 40 40 283 
282 283 283 283 284 0 0 0 205 244 283 283 283 283 283 283 283 283 283 283 283 283 284 0 0 0 0 0 0 0 0 0 205 203 203 244 283 40 40 40 40 40 40 40 40 40 40 40 283 40 283 40 40 284 0 0 0 282 40 40 40 40 40 283 
282 283 283 283 304 0 0 0 224 283 283 283 283 283 283 283 283 283 283 283 283 283 284 0 0 0 0 0 0 0 0 205 244 283 283 283 283 40 40 40 40 40 40 40 40 40 40 40 283 283 283 40 40 284 0 0 0 282 40 40 40 40 40 283 
282 40 40 283 222 0 0 0 224 283 283 283 283 283 283 283 283 283 283 283 283 283 284 0 0 205 263 263 263 263 263 244 283 283 40 40 40 40 40 283 40 40 283 283 283 283 40 40 40 40 40 40 40 284 0 0 0 282 40 40 283 283 283 283 
282 40 40 283 222 0 0 0 224 283 283 283 283 283 283 283 283 283 283 283 283 283 284 0 205 244 283 283 283 283 283 283 283 40 40 40 40 40 283 283 283 283 283 40 40 40 40 40 40 40 40 40 40 284 0 0 0 282 40 283 283 283 283 283 
282 40 40 283 242 206 0 0 224 303 303 303 283 283 283 303 303 303 303 303 303 303 304 0 224 283 283 283 283 40 40 40 40 40 40 40 40 40 40 40 40 40 40 40 40 40 40 40 40 40 40 40 40 284 0 0 0 282 283 283 283 283 283 283 
282 40 40 283 283 222 0 0 0 0 0 0 302 303 304 0 255 256 256 256 257 0 0 0 224 283 283 283 283 283 303 303 303 303 303 303 303 303 303 303 303 303 303 303 303 303 303 303 303 303 303 303 303 304 0 0 0 282 40 283 283 283 283 283 
282 40 40 40 283 242 206 0 0 0 0 0 0 0 255 256 279 276 276 276 277 0 0 0 224 283 283 283 283 283 222 0 0 0 0 0 0 0 0 0 0 0 0 0 0 0 0 0 0 0 0 0 0 0 0 0 0 282 40 40 283 283 283 283 
282 40 40 40 283 283 242 203 203 203 206 0 0 255 279 276 276 276 276 276 278 257 0 0 224 283 283 283 283 283 222 0 0 0 0 0 0 0 0 0 0 0 0 0 0 0 0 0 0 0 0 0 0 0 0 0 0 282 40 40 283 283 283 40 
282 40 40 40 40 283 283 283 283 283 242 206 0 295 296 259 276 276 276 276 258 297 205 243 244 283 283 283 283 283 242 263 263 263 263 263 263 263 263 263 263 263 263 263 263 263 263 263 263 263 263 263 263 263 263 263 263 282 40 40 283 283 283 40 
282 40 40 40 40 40 40 40 283 283 283 222 0 0 0 295 296 296 296 296 297 0 224 283 283 283 283 283 283 283 283 283 283 283 283 283 283 283 283 283 283 283 283 283 283 283 283 283 283 283 283 283 283 283 283 283 283 283 40 40 40 283 40 40 
282 40 40 40 40 40 40 40 40 40 283 242 203 203 203 206 0 0 0 0 0 0 224 283 283 283 283 283 283 283 40 40 40 40 40 40 40 40 40 40 40 40 40 40 40 40 40 40 40 40 40 40 40 40 40 40 40 283 283 283 283 283 40 40 
282 40 40 40 40 40 40 40 40 40 283 283 283 283 283 242 203 203 203 206 0 0 224 283 283 283 283 283 283 283 283 283 283 40 40 40 40 40 40 40 40 40 40 40 283 283 283 283 283 283 283 283 283 283 283 283 283 283 283 283 40 40 40 40 
282 40 40 40 40 40 40 40 40 40 40 40 40 40 283 283 283 283 283 242 243 243 244 283 283 283 283 283 283 283 283 283 283 283 283 40 283 40 40 40 40 40 40 283 283 283 283 283 283 283 283 40 40 40 40 40 40 40 40 40 40 40 40 40 
282 40 40 40 40 40 40 40 40 40 40 40 40 40 40 40 40 40 283 283 283 283 283 283 283 283 283 283 283 283 283 283 283 283 283 283 283 283 283 283 283 283 283 283 40 40 40 283 283 283 40 40 40 40 40 40 40 40 40 40 40 40 40 40 
282 40 40 40 40 40 40 40 40 40 40 40 40 40 40 40 40 40 40 40 40 283 283 283 283 283 283 283 283 283 283 283 283 283 283 283 283 283 283 283 283 283 283 283 283 40 40 40 40 40 40 40 40 40 40 40 40 40 40 40 40 40 40 40 
283 283 283 283 283 283 283 283 283 283 283 283 283 283 283 283 283 283 283 283 283 283 283 283 283 283 283 283 283 283 283 283 283 283 283 283 283 283 283 283 283 283 283 283 283 40 40 40 40 40 40 40 40 40 40 40 40 40 40 40 40 40 40 40