40 40 40 40 40 40 40 40 40 40 40 40 40 40 40 40 40 40 40 40 40 40 40 40 40 40 40 40 40 40 40 40 40 40 40 40 40 40 40 40 40 40 40 40 40 40 40 40 40 40 40 40 40 40 40 40 40 40 40 40 40 40 40 40 
156 156 156 156 156 156 156 156 156 156 156 156 156 156 156 156 156 156 156 156 156 156 156 156 156 156 40 40 40 40 40 40 40 40 40 40 40 40 40 40 40 40 40 40 40 40 40 40 40 40 40 40 40 40 40 40 40 40 40 40 40 40 40 40 
156 156 156 156 156 156 156 156 156 156 156 156 156 156 156 156 156 156 156 156 156 156 156 156 156 156 156 156 156 156 156 156 40 40 40 40 40 40 40 40 40 40 40 40 40 40 40 40 40 40 40 40 40 40 40 40 40 40 40 40 40 40 40 40 
156 156 156 156 156 156 156 156 156 156 156 156 156 156 156 156 156 156 156 156 156 156 156 156 156 156 156 156 156 156 156 156 156 156 156 156 156 156 156 156 156 156 156 156 156 156 156 156 156 156 156 156 156 156 156 156 156 156 40 40 40 40 40 40 
156 156 156 156 156 156 156 156 156 156 156 156 156 156 156 156 156 156 156 156 156 156 156 156 156 156 156 156 156 156 156 156 156 156 156 156 156 156 156 156 156 156 156 156 156 156 156 156 156 156 156 156 156 156 156 156 156 156 40 40 40 40 40 40 
156 156 156 156 156 156 156 156 156 156 156 156 156 156 156 156 156 156 171 40 40 40 40 40 40 40 40 40 40 156 156 156 156 156 156 156 156 156 156 156 156 156 156 156 156 156 156 156 156 156 156 156 156 156 156 156 156 156 40 40 40 40 40 40 
40 40 40 40 40 40 40 40 40 40 40 40 40 156 156 156 156 40 40 40 40 40 40 40 40 40 40 40 40 40 40 40 40 40 40 40 40 40 40 156 156 156 40 40 40 40 40 40 40 40 40 40 40 40 40 156 156 156 40 40 40 40 40 40 
40 40 40 40 40 40 40 40 40 40 40 40 40 156 156 156 156 40 40 40 40 40 40 40 40 40 40 40 40 40 40 40 40 40 40 40 40 40 40 156 156 156 40 40 40 40 40 40 40 40 40 40 40 40 40 156 156 156 40 40 40 40 40 40 
40 40 40 40 40 40 40 40 40 40 40 40 40 156 156 156 156 40 40 40 40 40 40 40 40 40 40 40 40 40 40 40 40 40 40 40 40 40 40 156 156 156 40 40 40 40 40 40 40 40 40 40 40 40 40 156 156 156 40 40 40 40 40 40 
40 40 40 40 40 40 40 40 40 40 40 40 40 156 156 156 156 40 40 40 40 40 40 40 40 40 40 40 40 40 40 40 40 40 40 40 40 40 40 156 156 156 40 40 40 40 40 40 40 40 40 40 40 40 40 156 156 156 40 40 40 40 40 40 
40 40 40 40 40 40 40 40 40 40 40 40 40 40 156 156 156 40 40 40 40 40 40 40 40 40 40 40 40 40 40 40 40 40 40 40 40 40 40 156 156 156 40 40 40 40 40 40 40 40 40 40 40 40 40 156 156 156 40 40 40 40 40 40 
40 40 40 40 40 40 40 40 40 40 40 40 40 40 156 156 156 40 40 40 40 40 40 40 40 40 40 40 40 40 40 40 40 40 40 40 40 40 40 156 156 156 40 40 40 40 40 40 40 40 40 40 40 40 40 156 156 156 40 40 40 40 40 40 
40 40 40 40 40 40 40 40 40 40 40 40 40 40 156 156 156 40 40 40 40 40 40 40 40 40 40 40 40 40 40 40 40 40 40 40 40 40 40 156 156 156 40 40 40 40 40 40 40 40 40 40 40 40 40 156 156 156 40 40 40 40 40 40 
40 40 40 40 40 156 156 156 156 156 156 156 156 156 156 156 156 156 156 156 40 40 40 40 40 40 40 40 40 40 40 40 40 40 40 40 40 40 40 156 156 156 40 40 40 40 40 40 40 156 156 156 156 156 156 156 156 156 40 40 40 40 40 40 
40 40 40 40 40 156 156 156 156 156 156 156 156 156 156 156 156 156 156 156 156 156 40 40 40 40 40 40 40 40 40 40 40 40 40 40 40 40 40 156 156 156 40 40 40 40 40 40 156 156 156 156 156 156 156 156 156 156 40 40 40 40 40 40 
40 40 40 40 40 156 156 156 156 156 156 156 156 156 156 156 156 156 156 156 156 156 40 40 40 40 40 40 40 40 40 40 40 40 40 40 40 40 40 156 156 156 40 40 40 40 40 40 156 156 156 156 156 156 156 156 156 156 40 40 40 40 40 40 
40 40 40 40 40 156 156 156 156 156 156 156 156 156 156 156 156 156 156 156 156 156 40 40 40 40 40 40 40 40 40 40 40 40 40 40 40 40 40 156 156 156 40 40 40 40 40 40 156 156 156 156 40 156 156 156 156 156 40 40 40 40 40 40 
40 40 40 40 156 156 156 156 156 156 156 156 156 156 156 156 156 156 156 156 156 156 40 40 40 40 40 40 40 40 40 40 40 40 40 40 40 156 156 156 156 156 40 40 40 40 40 40 40 40 40 40 40 40 40 156 156 156 40 40 40 40 40 40 
40 40 40 40 156 156 156 156 156 156 156 156 156 156 156 156 156 156 156 156 156 156 40 40 40 40 40 40 40 40 40 40 40 40 40 156 156 156 156 156 156 156 40 40 40 40 40 40 40 40 40 40 40 40 40 156 156 156 40 40 40 40 40 40 
40 40 40 40 156 156 156 156 156 156 156 156 156 156 156 156 156 156 156 156 156 40 40 40 40 40 40 40 40 40 40 40 40 40 40 156 156 156 156 156 156 156 40 40 40 40 40 40 40 40 40 40 40 40 40 156 156 156 40 40 40 40 40 40 
40 40 40 40 156 156 156 156 156 156 156 156 156 156 156 156 156 156 156 156 156 40 40 40 40 40 40 40 40 40 40 40 40 40 156 156 156 156 156 156 156 156 40 40 40 40 40 40 40 40 40 40 40 40 40 156 156 156 40 40 40 40 40 40 
40 40 40 40 40 40 40 156 156 156 156 156 156 156 156 156 156 156 156 156 40 40 40 40 40 40 40 40 40 40 40 40 156 156 156 156 156 156 156 156 156 156 40 40 40 40 40 40 40 40 40 40 40 40 40 156 156 156 40 40 40 40 40 40 
40 40 40 40 40 40 40 40 156 156 156 156 156 156 156 156 156 40 40 40 40 40 40 40 40 40 40 40 40 40 40 156 156 156 156 156 156 156 156 156 156 156 40 40 40 40 40 40 40 40 40 40 40 40 40 156 156 156 40 40 40 40 40 40 
40 40 40 40 40 40 40 40 156 156 156 156 156 156 40 40 40 40 40 40 40 40 40 40 40 40 40 40 40 40 156 156 156 156 156 156 156 156 156 156 156 156 40 40 40 40 40 40 40 40 40 40 40 40 40 156 156 156 40 40 40 40 40 40 
40 40 40 40 40 40 40 40 40 40 40 40 40 40 40 40 40 40 40 40 40 40 40 40 40 40 40 40 40 156 156 156 156 156 156 156 156 156 156 156 156 156 156 40 40 40 40 40 40 40 40 40 40 40 40 156 156 156 40 40 40 40 40 40 
40 40 40 40 40 40 40 40 40 40 40 40 40 40 40 40 40 40 40 40 40 40 40 40 40 40 156 156 156 156 156 156 156 156 156 156 156 156 156 156 156 156 156 156 156 40 40 40 40 40 40 40 40 40 40 156 156 156 40 40 40 40 40 40 
40 40 40 40 40 40 40 40 40 40 40 40 40 40 40 40 40 40 40 40 40 40 40 40 156 156 156 156 156 156 156 156 156 156 156 156 156 156 156 156 156 156 156 156 156 40 40 40 40 40 40 40 40 40 40 156 156 156 40 40 40 40 40 40 
40 40 40 40 40 40 40 40 40 40 40 40 40 40 40 40 40 40 40 40 40 40 40 156 156 156 156 156 156 156 156 156 156 156 156 156 156 156 156 156 156 156 156 156 156 40 40 40 40 40 40 40 40 40 40 156 156 156 40 40 40 40 40 40 
40 40 40 40 40 40 40 40 40 40 40 40 40 40 40 40 40 40 40 40 40 156 156 156 156 156 156 156 156 156 156 156 156 156 156 156 156 156 156 156 156 156 156 156 156 40 40 40 40 40 40 40 40 40 40 156 156 156 40 40 40 40 40 40 
40 40 40 40 40 40 40 40 40 40 40 40 40 40 40 40 40 40 40 40 40 156 156 156 156 156 156 156 156 156 156 156 156 156 156 156 156 156 156 156 156 156 156 156 156 40 40 40 40 40 40 40 40 40 40 156 156 156 40 40 40 40 40 40 
40 40 40 40 40 40 40 40 40 40 40 40 40 40 40 40 40 40 40 40 40 156 156 156 156 156 156 156 156 156 156 156 156 156 156 156 156 156 156 156 156 156 156 156 156 40 40 40 40 40 40 40 40 40 40 156 156 156 40 40 40 40 40 40 
40 40 40 40 40 40 40 40 40 40 40 40 40 40 40 40 40 40 40 40 40 156 156 156 156 156 156 156 156 156 156 156 156 156 156 156 156 156 156 156 156 156 156 156 156 40 40 40 40 40 40 40 40 40 40 156 156 156 40 40 40 40 40 40 
40 40 40 40 40 40 40 40 40 40 40 40 40 40 40 40 40 40 40 40 40 40 156 156 156 156 156 156 156 156 156 156 156 156 156 156 156 156 156 156 156 156 156 156 156 40 40 40 40 40 40 40 40 40 40 156 156 156 40 40 40 40 40 40 
40 40 40 40 40 40 40 40 40 40 40 40 40 40 40 40 40 40 40 40 40 40 40 156 156 156 156 156 156 156 156 156 156 156 156 156 156 156 156 156 156 156 156 156 156 40 40 40 40 40 40 40 40 156 156 156 156 156 40 40 40 40 40 40 
40 40 40 40 40 40 40 40 156 156 156 156 40 40 40 40 40 40 40 40 40 40 40 40 156 156 156 156 156 156 156 156 156 156 156 156 156 156 156 156 156 156 156 156 156 40 40 40 40 40 40 40 156 156 156 156 156 156 40 40 40 40 40 40 
40 40 40 40 40 40 40 40 156 156 156 156 156 156 156 40 40 40 40 40 40 40 40 40 40 40 40 40 40 40 156 156 156 156 156 156 156 156 156 40 40 40 40 40 40 40 40 40 40 40 40 156 156 156 156 156 156 156 40 40 40 40 40 40 
40 40 40 40 40 40 156 156 156 156 156 156 156 156 156 156 156 40 40 40 40 40 40 40 40 40 40 40 40 40 40 40 40 40 40 40 40 40 40 40 40 40 40 40 40 40 40 40 40 40 156 156 156 156 156 156 156 156 40 40 40 40 40 40 
40 40 40 40 40 40 156 156 156 156 156 156 156 156 156 156 156 156 156 40 40 40 40 40 40 40 40 40 40 40 40 40 40 40 40 40 40 40 40 40 40 40 40 40 40 40 40 40 40 156 156 156 156 156 156 156 156 156 40 40 40 40 40 40 
40 40 40 40 40 40 156 156 156 156 156 156 156 156 156 156 156 156 156 156 156 156 40 40 40 40 40 40 40 40 40 40 40 40 40 40 40 40 40 40 40 40 40 40 40 40 40 40 156 156 156 156 156 156 40 156 156 156 40 40 40 40 40 40 
40 40 40 40 40 40 156 156 156 156 156 156 156 156 156 156 156 156 156 156 156 156 40 40 40 40 40 40 40 40 40 40 40 40 40 40 40 40 40 40 40 40 40 40 40 156 156 156 156 156 156 156 156 40 40 156 156 156 40 40 40 40 40 40 
40 40 40 40 40 40 156 156 156 156 156 156 156 156 156 156 156 156 156 156 156 156 156 40 40 40 40 40 40 40 40 40 40 40 40 40 40 40 40 40 40 40 40 40 156 156 156 156 156 156 156 156 40 40 40 156 156 156 40 40 40 40 40 40 
148 148 148 148 148 148 148 148 148 148 148 148 148 148 148 148 148 148 148 148 148 148 148 148 148 148 148 148 148 148 148 148 148 148 148 148 148 148 148 148 148 148 148 148 148 148 148 148 148 148 148 148 148 148 148 148 148 148 148 148 148 148 148 40 
148 148 168 168 168 168 168 168 168 168 168 168 168 168 168 168 168 168 168 168 168 168 168 168 168 168 168 168 168 168 168 168 148 148 148 148 148 148 148 148 148 148 148 148 148 148 148 148 148 148 148 148 148 148 148 148 148 148 148 148 148 148 148 40 
148 148 0 0 0 0 0 0 0 0 0 0 0 0 0 0 0 0 0 0 0 0 0 0 0 0 0 0 0 0 0 0 168 168 168 168 168 168 168 168 168 168 168 168 168 168 168 168 168 168 168 168 168 168 168 168 168 168 131 38 148 40 40 40 
148 148 0 0 0 0 0 0 0 0 0 0 0 0 0 0 0 0 0 0 0 0 0 0 0 0 0 0 0 0 0 0 0 0 0 0 0 0 0 0 0 0 0 0 0 0 0 0 0 0 0 0 0 0 0 0 0 0 147 38 148 148 40 40 
148 148 0 0 0 0 0 0 0 0 0 0 0 0 0 0 0 0 0 0 0 0 0 0 0 0 0 127 128 129 0 0 0 0 0 0 0 0 0 0 0 0 0 0 0 0 0 0 0 0 0 0 0 0 0 0 0 0 147 38 38 148 40 40 
148 148 128 128 128 128 128 128 128 128 128 128 128 129 0 0 0 127 128 128 128 128 128 128 128 128 128 151 40 150 0 0 0 0 0 0 0 0 0 0 0 0 0 0 0 0 0 0 0 0 0 0 0 0 0 0 0 0 147 38 148 148 40 40 
148 148 40 40 40 40 40 40 40 40 40 40 40 149 0 0 0 147 40 40 40 40 40 40 40 40 40 40 40 150 128 128 128 128 128 128 128 128 129 0 0 0 127 128 128 128 128 128 128 128 128 128 128 128 129 0 0 0 147 38 148 40 40 40 
148 148 148 148 40 40 40 40 40 40 40 40 40 149 0 0 0 147 40 40 40 40 40 40 40 40 40 40 40 40 40 40 40 40 40 40 40 40 149 0 0 0 147 40 40 40 40 40 40 40 40 40 40 40 149 0 0 0 147 38 148 148 40 40 
148 148 148 148 148 148 148 40 40 40 40 40 40 149 0 0 0 147 40 40 40 40 40 40 40 40 40 40 40 40 40 40 40 40 40 40 40 40 149 0 0 0 147 40 40 40 40 40 40 40 40 40 40 40 149 0 0 0 147 38 38 148 40 40 
148 40 40 148 148 148 148 148 148 148 40 40 40 149 0 0 0 147 40 40 40 40 40 40 40 40 40 40 40 40 40 40 40 40 40 40 40 40 149 0 0 0 147 40 40 40 40 40 40 40 40 40 40 40 149 0 0 0 147 38 38 148 40 40 
148 40 148 148 40 148 148 148 40 148 148 40 40 149 0 0 0 147 40 40 40 40 40 40 40 40 40 40 40 40 40 40 40 40 40 40 40 40 149 0 0 0 147 40 40 40 40 40 40 40 40 40 40 40 149 0 0 0 147 38 38 148 40 40 
148 40 148 40 40 40 40 40 40 40 40 40 40 149 0 0 0 147 40 40 40 40 40 40 40 40 40 40 40 40 40 40 40 40 40 40 40 40 149 0 0 0 147 40 40 40 40 40 40 40 40 40 40 40 149 0 0 0 147 38 38 148 40 40 
148 148 148 40 130 168 168 168 168 168 168 168 168 169 0 0 0 167 168 168 131 40 40 40 40 40 40 40 40 40 40 40 40 40 40 40 40 40 149 0 0 0 147 40 40 40 40 40 130 168 168 168 168 168 169 0 0 0 147 38 38 148 148 40 
148 40 40 40 149 0 0 0 0 0 0 0 0 0 0 0 0 0 0 0 167 167 131 40 40 40 40 40 40 40 40 40 40 40 40 40 40 40 149 0 0 0 147 40 40 40 40 130 169 0 0 0 0 0 0 0 0 0 147 38 38 148 148 40 
148 40 40 40 149 0 0 0 0 0 0 0 0 0 0 0 0 0 0 0 0 0 147 40 40 40 40 40 40 40 40 40 40 40 40 40 40 40 149 0 0 0 147 40 40 40 40 149 0 0 0 0 0 0 0 0 0 0 147 38 38 148 148 40 
148 40 40 40 149 0 0 0 0 0 0 195 196 196 196 197 0 0 0 0 0 0 147 40 40 40 40 40 40 40 40 40 40 40 40 40 40 40 149 0 0 0 147 40 40 40 40 149 0 0 0 0 0 0 0 0 0 0 147 38 148 148 40 40 
148 40 40 130 169 0 0 0 0 195 196 239 25 25 25 217 0 0 0 0 0 0 147 40 40 40 40 40 40 40 40 40 40 40 40 40 130 168 169 0 0 0 147 40 40 40 40 149 0 0 0 0 148 0 0 0 0 0 147 38 148 40 40 40 
148 40 40 149 0 0 0 0 195 239 25 25 25 105 25 238 197 0 0 0 0 0 147 40 40 40 40 40 40 40 40 40 40 40 130 168 169 0 0 0 0 0 147 40 40 40 40 150 128 128 128 128 148 128 129 0 0 0 147 148 148 40 40 40 
148 40 40 149 0 0 0 0 235 236 219 25 25 25 25 218 237 0 0 0 0 0 147 40 40 40 40 40 40 40 40 40 40 40 149 0 0 0 0 0 0 0 147 40 40 40 40 40 40 40 40 40 40 40 149 0 0 0 147 40 40 40 40 40 
148 40 40 149 0 0 0 0 0 0 235 236 236 236 236 237 0 0 0 0 0 127 151 40 40 40 40 40 40 40 40 40 40 130 169 0 0 0 0 0 0 0 147 40 40 40 40 40 40 40 40 40 40 40 149 0 0 0 147 148 148 40 40 40 
148 40 40 149 0 0 0 0 0 0 0 0 0 0 0 0 0 0 0 0 0 147 40 40 40 40 40 40 40 40 40 130 168 169 0 0 0 0 0 0 0 0 147 40 40 40 40 40 40 40 40 40 40 40 149 0 0 0 147 40 148 148 40 40 
148 40 40 150 128 128 129 0 0 0 0 0 0 0 0 0 0 0 0 0 127 151 40 40 40 40 40 40 40 40 130 169 0 0 0 0 0 0 0 0 0 0 147 40 40 40 40 40 40 40 40 40 40 40 149 0 0 0 147 40 40 148 148 40 
148 40 40 40 40 40 150 129 0 0 0 0 0 0 0 0 0 127 128 128 151 40 40 40 40 40 40 40 40 130 169 0 0 0 0 0 0 0 0 0 0 0 147 40 40 40 40 40 40 40 40 40 40 40 149 0 0 0 147 40 40 148 148 40 
148 40 40 40 40 40 40 149 0 0 0 0 0 0 127 128 128 151 40 40 40 40 40 40 40 40 40 40 130 169 0 0 0 0 0 195 197 0 0 0 0 0 167 131 40 40 40 40 40 40 40 40 40 40 149 0 0 0 147 40 40 148 148 40 
148 40 40 40 40 40 40 150 128 128 128 128 128 128 151 40 40 40 40 40 40 40 40 40 40 130 168 168 169 0 0 0 0 0 195 239 217 0 0 0 0 0 0 167 168 131 40 40 40 40 40 40 40 40 149 0 0 0 147 40 40 148 40 40 
148 40 40 40 40 40 40 40 40 40 40 40 40 40 40 40 40 40 40 40 40 40 40 130 168 169 0 0 0 0 0 0 0 195 239 218 237 0 0 0 0 0 0 0 0 147 40 40 40 40 40 40 40 40 149 0 0 0 147 40 40 148 40 40 
148 40 40 40 40 40 40 40 40 40 40 40 40 40 40 40 40 40 40 40 40 40 130 169 0 0 0 0 0 0 0 0 195 239 218 237 0 0 0 0 0 0 0 0 0 147 40 40 40 40 40 40 40 40 149 0 0 0 147 40 40 148 40 40 
148 40 40 40 40 40 40 40 40 40 40 40 40 40 40 40 40 40 40 40 130 168 169 0 0 0 0 0 0 0 0 195 239 218 237 0 0 0 0 0 0 0 0 0 0 147 40 40 40 40 40 40 40 40 149 0 0 0 147 40 40 148 40 40 
148 40 40 40 40 40 40 40 148 148 148 40 40 40 40 40 40 40 40 40 149 0 0 0 0 0 0 0 0 195 196 239 218 237 0 0 0 0 0 0 0 0 0 0 0 147 40 40 40 148 148 148 40 40 149 0 0 0 147 40 40 148 40 40 
148 40 40 40 40 40 148 148 148 40 148 148 148 148 148 148 40 40 40 40 149 0 0 0 0 0 0 0 195 239 218 236 237 0 0 0 0 0 0 0 0 0 0 0 0 147 40 40 40 40 148 148 40 40 149 0 0 0 147 40 40 148 40 40 
148 40 40 40 148 148 148 40 40 40 40 40 40 40 40 40 40 40 40 40 149 0 0 0 0 0 0 195 239 218 237 0 0 0 0 0 0 0 0 0 0 0 0 0 0 147 40 40 40 40 40 148 40 40 149 0 0 0 147 40 40 148 40 40 
148 40 40 148 40 148 40 40 40 40 40 40 40 40 40 40 40 40 40 40 149 0 0 0 0 0 0 235 236 237 0 0 0 0 0 0 0 0 0 0 0 0 0 0 0 147 40 40 40 40 40 40 40 40 149 0 0 0 147 40 40 148 40 40 
148 40 148 40 40 40 40 40 40 40 40 40 40 40 40 40 40 40 40 40 150 129 0 0 0 0 0 0 0 0 0 0 0 0 0 0 0 0 0 0 0 0 0 0 0 147 40 40 40 40 40 40 130 168 169 0 0 0 147 40 40 148 40 40 
148 148 40 40 40 40 40 130 168 168 168 168 131 40 40 40 40 40 40 40 40 150 129 0 0 0 0 0 0 0 0 0 0 0 0 0 0 0 0 0 0 0 0 0 0 147 40 40 40 40 40 130 169 0 0 0 0 0 147 40 40 148 40 40 
148 40 40 40 40 40 40 149 0 0 0 0 167 168 131 40 40 40 40 40 40 40 150 129 0 0 0 0 0 0 0 0 0 0 0 0 0 0 0 0 0 0 0 0 0 147 40 40 40 40 130 169 0 0 0 0 0 0 147 40 40 148 40 40 
148 40 40 40 40 130 168 169 0 0 0 0 0 0 0 167 168 131 40 40 40 40 40 150 128 128 128 128 128 129 0 0 0 0 0 0 0 0 0 127 128 128 128 128 128 151 40 40 40 130 169 0 0 0 0 0 0 0 147 40 40 148 40 40 
148 40 40 40 40 149 0 0 0 0 0 0 0 0 0 0 0 167 168 131 40 40 40 40 40 40 40 40 40 150 128 128 128 128 128 128 128 128 128 151 40 40 40 40 40 40 40 40 130 169 0 0 0 0 0 0 0 0 147 40 148 148 40 40 
148 40 40 40 40 149 0 0 0 0 0 0 0 0 0 0 0 0 0 167 168 168 131 40 40 40 40 40 40 40 40 40 40 40 40 40 40 40 40 40 40 40 40 40 40 40 40 130 169 0 0 0 0 0 0 0 0 0 147 40 148 40 40 40 
148 40 40 40 40 149 0 0 0 0 0 0 0 0 0 0 0 0 0 0 0 0 147 40 40 40 40 40 40 40 40 40 40 40 40 40 40 40 40 40 40 40 40 40 130 168 168 169 0 0 0 0 0 127 148 0 0 0 147 40 148 148 40 40 
148 40 40 40 40 149 0 0 0 0 0 0 0 0 0 0 0 0 0 0 0 0 167 131 40 40 40 40 40 40 40 40 40 40 40 40 40 40 40 40 40 40 40 130 169 0 0 0 0 0 0 0 0 147 149 0 0 0 147 40 40 148 40 40 
148 40 40 40 40 149 0 0 0 0 0 0 0 0 0 0 0 0 0 0 0 0 0 167 131 40 40 40 40 40 40 40 40 40 40 40 40 40 40 40 40 40 130 169 0 0 0 0 0 0 0 0 148 147 149 0 0 0 147 148 148 148 148 148 
148 40 40 40 40 149 0 0 0 0 0 0 0 0 0 0 0 0 0 0 0 0 0 0 167 168 131 40 40 40 40 40 40 40 40 40 40 130 168 168 168 168 169 0 0 0 0 0 0 0 148 147 148 148 149 0 0 0 147 40 40 40 148 148 
148 40 40 40 40 149 0 0 0 0 0 0 0 0 0 0 0 0 0 0 0 0 0 0 0 0 167 131 40 40 40 40 40 40 40 40 130 169 0 0 0 0 0 0 0 0 0 0 148 147 148 148 148 148 149 0 0 0 147 40 40 40 40 148 
148 40 40 40 40 149 0 0 0 0 0 0 0 0 0 0 0 0 0 0 0 0 0 0 0 0 0 147 40 40 40 40 130 168 168 168 169 0 0 0 0 0 0 0 0 0 0 148 147 148 40 40 40 40 149 0 0 0 147 40 40 40 40 148 
148 40 40 40 148 150 129 0 0 0 0 0 0 0 0 0 0 0 0 0 0 0 0 0 0 0 0 147 40 40 40 40 149 0 0 0 0 0 0 0 0 0 0 0 0 0 148 147 148 148 40 40 40 148 171 0 0 0 147 40 40 40 40 148 
148 40 40 40 40 130 169 0 0 0 0 0 0 0 0 0 0 0 0 0 0 0 0 0 0 0 0 147 40 130 168 168 169 0 0 0 0 0 0 0 0 148 148 148 148 148 148 40 40 40 40 40 40 149 0 0 0 0 147 40 40 40 40 148 
148 40 40 40 130 169 0 0 0 0 0 0 0 0 0 0 0 0 0 0 0 0 0 0 0 0 0 167 168 169 0 0 0 0 0 0 0 0 0 0 148 148 40 40 40 40 40 40 40 40 40 40 40 149 0 0 0 0 147 40 40 40 40 148 
148 40 148 40 149 0 0 0 0 0 127 128 128 128 128 128 128 128 128 128 129 0 0 0 0 0 0 0 0 0 0 0 0 0 0 0 148 148 148 148 148 40 40 40 40 40 40 40 40 40 40 40 40 149 0 0 0 130 148 40 40 40 40 148 
148 148 148 40 149 0 0 0 0 0 147 148 148 148 148 148 148 148 148 148 150 128 129 0 0 0 0 0 0 0 0 0 0 0 0 0 148 40 40 40 40 40 40 40 40 40 40 40 148 40 148 40 40 149 0 0 0 147 40 40 40 40 40 148 
148 148 148 130 169 0 0 0 0 127 151 148 148 148 148 148 148 148 148 148 148 148 149 0 0 0 0 0 0 0 0 0 0 148 148 148 148 40 40 40 40 40 40 40 40 40 40 40 148 148 148 40 40 149 0 0 0 147 40 40 40 40 40 148 
148 40 40 149 0 0 0 0 0 147 148 148 148 148 148 148 148 148 148 148 148 148 149 0 0 0 0 0 0 0 0 0 127 151 40 40 40 40 40 148 40 40 148 148 148 148 40 40 40 40 40 40 40 149 0 0 0 147 40 40 148 148 148 148 
148 40 40 149 0 0 0 0 0 147 148 148 148 148 148 148 148 148 148 148 148 148 149 0 0 0 128 128 128 128 128 128 151 40 40 40 40 40 148 148 148 148 148 40 40 40 40 40 40 40 40 40 40 149 0 0 0 147 40 148 148 148 148 148 
148 40 40 149 0 0 0 0 0 167 168 168 131 148 130 168 168 168 168 168 168 168 149 0 0 131 148 148 148 40 40 40 40 40 40 40 40 40 40 40 40 40 40 40 40 40 40 40 40 40 40 40 40 149 0 0 0 147 148 148 148 148 148 148 
148 40 40 130 129 0 0 0 0 0 0 0 167 168 169 0 0 0 0 0 0 0 0 0 0 147 148 148 148 130 168 168 168 168 168 168 168 168 168 168 168 168 168 168 168 168 168 168 168 168 168 168 168 169 0 0 0 147 40 148 148 148 148 148 
148 40 40 40 149 0 0 0 0 0 0 0 0 0 0 0 0 0 0 0 0 0 0 0 0 147 148 148 148 149 0 0 0 0 0 0 0 0 0 0 0 0 0 0 0 0 0 0 0 0 0 0 0 0 0 0 0 147 40 40 148 148 148 148 
148 40 40 40 149 129 0 0 0 0 0 0 0 0 0 0 0 0 0 0 0 0 0 0 0 147 148 148 148 149 0 0 0 0 0 0 0 0 0 0 0 0 0 0 0 0 0 0 0 0 0 0 0 0 0 0 0 147 40 40 148 148 148 40 
148 40 40 40 40 150 128 128 128 129 0 0 0 0 0 0 0 0 0 0 0 0 0 0 0 147 148 148 148 149 0 0 0 0 0 0 0 0 0 0 0 0 0 0 0 0 0 0 0 0 0 0 0 0 0 0 0 147 40 40 148 148 148 40 
148 40 40 40 40 40 40 40 40 150 129 0 0 0 0 0 0 0 0 0 0 0 0 127 128 151 148 148 148 150 128 128 128 128 128 128 128 128 128 128 128 128 128 128 128 128 128 128 128 128 128 128 128 128 128 128 128 151 40 40 40 148 40 40 
148 40 40 40 40 40 40 40 40 40 149 0 0 0 0 0 0 0 0 0 0 0 0 147 148 148 148 148 148 40 40 40 40 40 40 40 40 40 40 40 40 40 40 40 40 40 40 40 40 40 40 40 40 40 40 40 40 148 148 148 148 148 40 40 
148 40 40 40 40 40 40 40 40 40 150 128 128 128 129 0 0 0 0 0 0 0 0 147 148 148 148 148 148 148 148 148 148 40 40 40 40 40 40 40 40 40 40 40 148 148 148 148 148 148 148 148 148 148 148 148 148 148 148 148 40 40 40 40 
148 40 40 40 40 40 40 40 40 40 40 40 40 40 150 128 128 128 129 0 0 0 0 147 148 127 148 148 148 148 148 148 148 148 148 40 148 40 40 40 40 40 40 148 148 148 148 148 148 148 148 40 40 40 40 40 40 40 40 40 40 40 40 40 
148 40 40 40 40 40 40 40 40 40 40 40 40 40 40 40 40 40 150 128 128 128 128 148 148 148 148 148 148 148 148 148 148 148 148 148 148 148 148 148 148 148 148 148 40 40 40 148 148 148 40 40 40 40 40 40 40 40 40 40 40 40 40 40 
148 40 40 40 40 40 40 40 40 40 40 40 40 40 40 40 40 40 40 40 40 148 148 148 148 148 148 148 148 148 148 148 148 148 148 148 148 148 148 148 148 148 148 148 148 40 40 40 40 40 40 40 40 40 40 40 40 40 40 40 40 40 40 40 
148 148 148 148 148 148 148 148 148 148 148 148 148 148 148 148 148 148 148 148 148 148 148 148 148 148 148 148 148 148 148 148 148 148 148 148 148 148 148 148 148 148 148 148 148 40 40 40 40 40 40 40 40 40 40 40 40 40 40 40 40 40 40 40