283 283 283 283 303 303 303 303 303 303 303 303 303 303 303 303 303 303 303 303 303 303 303 303 303 303 303 303 303 303 303 303 303 303 303 303 303 303 303 303 303 303 303 303 303 303 303 303 303 303 303 303 303 303 303 303 303 303 303 303 303 283 283 284 
283 283 283 284 264 0 0 0 0 0 0 0 0 0 0 0 0 0 0 0 0 0 0 0 0 0 0 0 0 0 0 0 0 0 0 0 0 0 0 0 0 0 0 0 0 0 0 0 0 0 0 0 0 0 0 0 0 0 0 0 0 282 283 284 
283 283 40 283 284 264 0 0 69 0 0 0 0 0 0 0 0 0 0 0 0 262 263 263 263 263 263 263 263 263 263 263 263 263 263 263 263 263 263 263 263 263 264 0 0 0 0 0 0 0 262 263 263 263 263 263 263 263 263 263 263 282 283 284 
283 283 40 40 283 284 264 0 0 0 0 0 0 0 0 0 0 0 0 0 0 282 283 283 283 283 283 283 283 283 283 283 283 283 283 283 283 283 283 283 283 283 284 0 0 0 0 0 0 0 282 303 303 303 303 303 283 283 283 283 283 283 283 284 
283 283 283 40 40 283 284 264 0 0 0 0 0 0 0 0 0 0 0 0 0 302 283 40 40 40 40 40 40 40 40 40 40 40 40 40 40 40 40 40 40 40 284 0 0 0 0 0 0 0 281 0 0 0 0 0 302 303 303 303 283 283 283 284 
283 283 303 303 283 40 283 284 264 0 0 0 0 0 0 0 0 0 0 0 0 0 302 283 40 40 40 40 40 40 40 40 40 40 40 40 40 40 40 40 40 40 284 0 0 0 0 0 0 0 281 0 0 0 0 0 0 0 0 0 283 283 283 284 
283 284 69 0 302 283 40 283 284 264 0 0 0 0 20 0 0 0 0 0 0 0 0 302 283 40 40 40 40 40 40 40 40 40 40 40 40 40 40 40 40 40 284 0 0 0 0 0 0 0 281 0 0 0 69 0 0 0 0 0 302 303 283 284 
283 284 0 0 0 282 40 40 283 284 264 0 0 0 0 0 0 0 0 0 0 0 0 0 302 303 303 303 303 303 303 303 303 303 303 303 303 303 303 303 303 303 284 0 0 0 69 0 0 0 281 0 0 0 0 0 0 0 0 0 0 0 282 284 
283 284 0 0 0 302 283 40 40 283 284 264 0 0 0 0 0 0 0 0 0 0 0 0 0 0 0 0 0 0 0 0 0 0 0 0 0 0 0 0 0 0 281 263 263 263 263 263 263 263 281 0 0 0 0 0 0 0 0 0 0 0 282 284 
283 284 0 0 0 0 302 283 40 40 283 284 264 0 0 0 0 0 0 0 0 0 0 0 0 0 0 0 0 0 0 0 0 0 0 0 0 0 0 0 0 0 302 303 303 303 303 303 303 303 304 0 0 0 0 0 0 0 0 0 0 0 282 284 
283 284 0 0 0 0 0 302 283 40 40 283 284 264 0 0 0 0 0 0 0 0 0 0 262 263 263 263 263 263 263 263 263 263 263 263 263 264 0 0 0 0 0 0 0 0 0 0 0 0 0 0 0 0 0 0 0 0 0 0 0 0 282 284 
283 284 0 0 0 0 0 0 302 283 40 40 283 284 264 0 0 0 0 0 0 0 0 0 282 283 283 283 283 283 283 283 283 283 283 283 283 284 0 0 0 0 0 0 0 0 0 0 0 0 0 0 0 0 0 20 0 0 0 20 0 0 282 284 
283 284 0 0 0 0 0 0 0 302 283 40 40 283 284 264 0 0 0 0 0 0 0 262 282 40 40 40 40 40 40 40 40 40 40 40 40 284 0 0 0 0 0 0 0 0 0 0 0 0 0 0 0 0 0 0 0 0 0 0 0 0 282 284 
283 284 0 0 0 0 0 0 0 0 302 283 40 40 283 284 264 0 0 0 0 0 0 282 283 40 40 40 40 40 40 40 40 40 40 40 40 284 0 0 0 262 263 263 263 263 263 263 263 263 263 263 263 263 263 263 263 263 263 263 263 263 282 284 
283 284 0 0 69 0 0 0 0 0 0 302 283 40 40 283 284 264 0 0 69 0 0 282 40 40 40 40 40 40 40 40 40 40 40 40 40 284 0 0 0 282 303 303 303 303 303 303 303 303 303 303 303 303 303 303 303 303 303 303 303 303 283 284 
283 284 0 0 0 0 0 0 0 0 0 0 302 283 40 40 283 284 263 263 263 263 263 282 40 40 40 40 40 40 40 40 40 40 40 40 40 284 0 0 0 281 0 0 0 0 0 0 0 0 0 0 0 0 0 0 0 0 0 0 0 0 283 284 
283 284 0 0 0 69 0 0 0 0 0 0 0 282 40 40 40 283 283 283 283 283 283 283 40 40 40 40 40 40 40 40 40 40 40 40 40 284 0 0 0 281 0 0 0 0 0 0 0 0 0 0 20 0 0 0 0 0 0 0 0 0 283 284 
283 284 0 0 0 0 0 0 0 0 0 0 0 302 283 40 40 40 283 283 283 283 283 303 303 303 303 303 303 303 303 303 303 303 303 303 303 304 0 0 0 281 0 0 0 0 0 0 0 0 0 20 20 20 0 0 0 0 0 0 69 0 283 284 
283 284 0 0 0 0 0 0 0 0 0 0 0 0 302 283 40 40 40 40 40 40 284 0 0 0 0 0 0 0 0 0 0 0 0 0 0 0 0 0 0 281 0 0 0 0 0 0 0 0 0 0 0 0 0 0 0 0 0 0 0 0 283 284 
283 284 0 0 0 0 0 0 0 0 0 0 0 0 0 302 283 40 40 40 40 40 284 264 264 0 0 0 0 0 0 0 0 0 0 0 0 0 0 0 0 281 263 263 263 263 263 263 263 263 264 0 0 0 262 263 263 263 263 263 263 263 283 284 
283 284 0 0 0 0 0 0 0 0 0 0 0 0 0 0 302 303 283 40 40 40 283 283 284 264 0 0 0 0 0 69 0 0 0 0 0 261 0 0 0 302 303 303 303 303 303 303 303 303 304 0 0 0 302 303 303 303 303 303 303 303 283 284 
283 284 0 0 0 0 0 0 0 0 0 0 0 0 0 0 0 0 282 40 40 40 40 40 283 284 264 0 0 0 0 0 0 0 0 0 0 281 0 0 0 0 0 0 0 0 0 0 0 0 0 0 0 0 0 0 0 0 0 0 0 0 283 284 
283 284 0 0 0 0 0 0 0 0 0 0 0 0 0 0 0 0 302 283 40 40 40 40 40 283 284 264 0 0 0 19 19 0 0 0 0 281 0 0 0 0 0 0 0 0 0 0 0 0 0 0 0 0 0 0 0 0 0 0 0 0 283 284 
283 284 0 0 0 0 19 0 0 0 0 0 0 0 0 0 0 0 0 282 40 40 40 40 40 40 283 284 0 0 0 0 0 0 0 0 0 281 0 0 0 262 263 263 263 263 263 263 263 263 263 263 263 263 263 263 263 263 263 263 263 263 283 284 
283 284 0 0 0 0 0 0 0 0 0 0 0 0 0 0 0 0 0 302 283 40 40 40 40 40 40 284 263 263 263 263 263 263 263 263 263 281 0 0 0 282 303 303 303 303 303 303 303 303 303 303 303 303 303 303 303 303 303 303 303 303 283 284 
283 284 0 0 0 0 0 0 0 69 0 0 0 0 0 0 0 0 0 0 302 283 283 40 40 40 40 283 283 283 283 283 283 283 283 283 283 283 0 0 0 281 0 0 0 0 0 0 0 0 0 0 0 0 0 0 0 0 0 0 0 19 282 284 
283 284 0 0 0 0 69 0 0 0 0 0 0 0 0 0 0 0 0 0 0 302 283 40 40 40 40 40 40 40 40 40 40 40 40 40 281 0 0 0 0 281 0 0 0 0 0 0 0 0 0 0 0 0 0 0 0 0 0 0 0 19 282 284 
283 284 0 0 0 0 0 0 19 0 0 0 0 0 0 0 0 0 0 0 0 0 282 40 40 40 40 40 40 40 40 40 40 40 40 40 281 0 0 0 0 281 0 0 0 0 0 0 0 0 0 0 69 0 0 0 0 0 0 0 0 0 282 284 
283 284 0 0 0 0 0 0 0 247 248 248 249 0 0 0 0 0 0 0 0 0 302 303 283 40 40 40 40 40 40 40 40 40 40 40 281 0 0 0 0 281 0 0 0 0 0 0 0 0 0 0 0 0 0 0 0 0 0 0 19 19 282 284 
283 284 0 0 0 0 0 0 0 267 268 268 269 0 0 0 0 0 0 0 0 0 0 0 302 283 40 40 40 40 40 40 40 40 40 40 281 0 0 0 0 281 0 0 0 0 0 0 0 0 0 0 0 0 0 0 0 0 19 19 19 19 282 284 
283 284 0 0 0 0 0 0 0 287 273 268 269 0 0 0 0 0 0 0 0 0 0 0 0 302 303 40 40 40 40 40 40 40 40 40 281 0 0 0 0 281 0 0 0 0 0 0 0 0 0 0 0 0 0 0 0 0 0 19 0 0 282 284 
283 284 0 0 0 0 0 0 0 247 293 268 269 0 0 0 0 0 0 0 0 0 0 0 0 0 0 282 40 40 40 40 40 40 40 40 281 0 0 0 0 281 264 0 0 0 0 0 0 0 0 0 20 0 0 0 0 0 0 0 0 0 282 284 
283 284 0 0 0 0 0 0 0 287 288 288 289 0 0 0 0 0 0 0 0 0 0 0 0 0 0 302 283 40 40 40 40 40 40 40 281 0 0 0 0 302 284 264 0 0 0 0 0 0 20 20 20 20 0 0 0 0 0 0 0 0 282 284 
283 284 0 0 0 0 0 262 264 0 0 0 0 0 0 0 0 0 0 0 0 0 0 0 0 0 0 0 302 283 283 40 40 40 40 40 281 264 0 0 0 0 302 284 264 0 0 0 0 0 0 0 20 0 0 0 0 0 0 0 0 0 282 284 
283 284 0 0 0 0 262 282 284 264 0 0 0 0 0 0 0 0 0 0 0 0 0 0 0 0 0 0 0 0 302 303 283 40 40 40 40 284 264 0 0 0 0 302 284 264 0 0 0 0 0 0 0 0 0 0 0 0 0 0 0 0 282 284 
283 284 0 0 0 0 282 283 283 284 264 0 0 0 0 0 0 0 0 0 0 0 0 0 0 0 0 0 0 0 0 0 282 40 40 40 40 283 284 264 0 0 0 0 302 284 0 0 0 0 0 0 0 0 0 0 0 0 0 0 0 0 282 284 
283 284 0 0 0 0 282 283 283 283 284 264 0 0 0 0 0 0 0 0 0 0 0 0 0 0 0 0 0 0 0 0 302 283 40 40 40 40 283 284 264 0 0 0 0 281 0 0 0 0 0 0 0 0 0 0 0 0 0 0 0 0 282 284 
283 284 0 0 0 0 282 283 303 303 283 284 264 0 0 0 0 0 0 0 0 0 0 0 0 0 0 0 0 0 0 0 0 282 40 40 40 40 40 283 284 264 0 0 0 281 263 263 263 263 263 263 263 263 263 264 0 0 0 0 0 0 282 284 
283 284 0 0 0 0 282 284 20 19 282 283 304 0 0 0 0 0 0 0 0 0 0 0 0 0 0 0 0 0 0 0 0 302 283 40 40 40 40 40 283 284 264 0 0 302 303 303 303 303 303 303 303 303 303 304 0 0 0 0 0 0 282 284 
283 284 0 0 0 0 282 284 20 19 282 304 0 0 0 0 0 0 0 0 0 0 0 0 0 0 0 0 0 0 0 0 0 0 302 283 40 40 40 40 40 283 284 0 0 0 0 0 0 0 0 0 0 0 0 0 0 0 0 0 0 0 282 284 
283 284 0 0 0 0 282 283 283 283 304 0 0 0 0 0 0 0 0 0 0 0 0 0 0 0 0 0 0 0 0 0 0 0 0 302 283 40 40 40 40 40 284 263 264 0 0 0 0 0 263 263 263 263 263 263 204 0 0 0 0 0 282 284 
283 284 0 0 0 0 282 283 283 304 0 0 0 0 0 0 0 0 0 0 0 0 0 0 0 0 0 0 0 0 0 0 0 0 0 0 302 283 40 40 40 40 283 283 284 0 0 0 0 0 302 303 303 303 303 303 284 264 0 0 0 0 282 284 
283 284 0 0 0 0 302 303 304 0 0 0 0 0 0 0 0 262 263 263 263 263 263 263 264 0 0 0 0 0 0 0 0 0 0 0 0 302 283 40 40 40 40 40 284 264 0 0 0 0 0 0 0 0 0 0 302 283 0 0 0 0 282 284 
283 284 0 0 0 0 0 0 0 0 0 0 0 0 0 0 0 282 303 303 303 303 303 303 304 0 0 0 0 0 0 0 0 0 0 0 0 0 302 303 283 40 40 40 283 284 264 0 0 0 0 0 0 0 0 0 0 281 0 0 0 0 282 284 
283 284 0 0 0 0 0 0 0 0 0 0 0 262 263 263 263 281 0 0 0 0 0 0 0 0 0 0 0 0 0 0 0 0 0 0 0 0 0 0 302 283 40 40 40 283 284 264 0 0 0 0 0 0 0 0 0 281 0 0 0 0 282 284 
283 284 0 0 0 0 0 0 0 0 0 0 0 302 303 303 303 304 0 0 0 0 0 0 0 0 0 0 0 0 0 262 263 264 0 0 0 0 0 0 0 302 283 40 40 40 283 284 264 0 0 0 69 0 0 0 0 281 0 0 0 0 282 284 
283 284 0 0 0 0 0 0 0 0 0 0 0 0 0 0 0 0 0 0 0 0 0 0 0 0 0 0 0 0 0 282 283 284 0 0 0 0 0 0 0 0 302 283 40 40 40 283 284 264 0 0 0 0 0 0 0 281 0 0 0 0 282 284 
283 284 0 0 0 0 0 0 0 19 0 0 0 0 0 0 0 0 0 0 0 0 0 0 0 0 0 0 0 0 0 302 303 304 0 0 0 0 0 0 0 0 0 302 283 40 40 40 283 284 264 0 0 0 0 0 0 281 0 0 0 0 282 284 
283 284 0 0 0 0 0 0 0 0 0 0 0 0 0 0 0 0 0 0 0 0 0 0 0 0 0 0 0 0 0 0 0 0 0 0 0 0 0 0 0 0 0 0 282 40 40 40 40 283 284 264 0 0 0 0 0 281 0 0 0 0 282 284 
283 284 0 0 0 0 0 0 0 0 0 0 0 0 0 0 0 0 0 0 247 248 248 248 248 249 0 0 0 0 0 0 0 0 0 0 0 0 0 0 0 0 0 0 302 283 40 40 40 40 283 283 19 19 0 0 0 281 0 0 0 0 282 284 
283 284 0 0 0 69 0 0 0 0 0 0 0 0 0 0 0 0 0 69 267 268 268 268 268 292 249 0 0 0 0 0 0 0 0 0 0 0 0 0 0 0 0 0 0 302 283 40 40 40 40 283 284 19 19 69 0 281 263 264 0 0 282 284 
283 284 0 0 0 0 0 0 0 0 0 0 0 0 0 0 0 0 0 0 287 273 268 268 268 268 269 0 0 0 0 0 0 0 0 0 0 0 0 0 0 0 0 0 0 0 302 283 40 40 40 40 283 283 19 19 0 302 303 284 0 0 282 284 
283 284 0 0 0 0 0 0 0 0 0 0 0 0 0 0 0 0 0 0 247 293 268 268 268 268 269 0 0 0 0 0 0 0 0 0 0 0 0 0 0 0 0 0 0 0 0 302 283 40 40 40 40 283 283 19 19 19 19 281 0 0 282 284 
283 284 0 0 0 0 0 0 0 0 0 261 0 0 0 0 0 0 0 0 287 288 288 288 288 288 289 0 0 0 0 0 0 69 0 0 0 0 0 0 0 0 0 0 0 0 0 0 302 40 40 40 40 40 283 283 19 19 19 281 0 0 282 284 
283 284 0 0 0 0 0 0 0 0 0 281 0 0 0 20 0 0 0 0 0 0 0 0 0 0 0 0 0 0 0 0 0 0 0 0 0 0 0 0 0 0 0 0 0 0 0 0 0 302 283 40 40 40 40 283 283 19 19 281 0 0 282 284 
283 284 0 0 0 0 0 0 0 0 0 281 0 0 0 0 0 0 0 0 69 0 0 19 0 0 0 0 261 0 0 0 0 0 0 0 0 0 0 0 0 0 0 0 0 261 0 0 0 0 302 303 283 40 40 40 283 283 19 281 0 0 282 284 
283 284 0 0 0 0 0 0 0 0 0 281 0 0 0 0 0 0 0 0 0 0 0 0 0 0 0 0 281 0 0 0 0 0 0 0 0 0 0 0 0 0 0 0 0 281 0 0 0 0 0 0 302 283 40 40 40 283 283 284 0 0 282 284 
283 284 0 0 0 0 0 0 0 0 0 281 0 0 0 0 0 0 0 0 0 0 0 0 0 0 0 0 281 0 0 0 0 0 0 0 0 0 0 0 0 0 0 0 0 281 0 0 0 0 0 0 0 302 303 40 40 40 283 284 0 0 282 284 
283 284 0 0 0 262 263 263 263 263 263 281 0 0 0 262 263 263 263 263 263 263 263 263 263 263 263 263 281 0 0 0 0 0 0 0 0 0 0 0 0 0 0 0 0 281 0 0 0 0 0 0 0 0 0 302 283 40 40 284 0 0 282 284 
283 284 0 0 0 302 303 303 303 303 303 304 0 0 0 302 303 303 303 303 303 303 303 303 303 303 303 303 304 0 0 0 0 0 262 263 263 263 263 263 263 263 263 263 263 281 0 0 0 0 0 0 0 0 0 0 302 303 303 304 0 0 282 284 
283 284 0 0 0 0 0 0 0 0 0 0 0 0 0 0 0 0 0 0 0 0 0 0 0 0 0 0 0 0 0 0 0 0 302 303 303 303 303 303 303 303 303 303 303 304 0 0 0 0 0 0 0 0 0 0 0 0 0 0 0 19 282 284 
283 284 263 263 263 263 263 263 263 263 263 263 263 263 263 263 263 263 263 263 263 263 263 263 263 263 263 263 263 263 263 263 263 263 263 263 263 263 263 263 263 263 263 263 263 263 263 263 263 263 263 263 263 263 263 263 263 263 263 263 263 263 282 284 
283 283 283 283 283 283 283 283 283 283 283 283 283 283 283 283 283 283 283 283 283 283 283 283 283 283 283 283 283 283 283 283 283 283 283 283 283 283 283 283 283 283 283 283 283 283 283 283 283 283 283 283 283 283 283 283 283 283 283 283 283 283 283 284 
283 303 303 303 303 303 303 303 303 303 303 303 303 303 303 303 303 303 303 303 303 303 303 303 303 303 303 303 303 303 303 303 303 303 303 303 303 303 303 303 303 303 303 303 303 303 303 303 303 303 303 303 303 303 303 303 303 303 303 303 303 303 303 304
