25 25 25 25 25 67 25 25 25 25 25 25 25 25 25 25 25 25 25 25 25 67 67 67 67 67 67 67 67 67 67 25 25 25 25 25 25 25 25 25 25 25 25 25 25 67 25 25 25 25 25 25 25 25 25 25 25 25 25 25 25 25 25 25 
25 25 67 25 25 25 25 25 25 25 25 25 25 25 25 25 25 67 25 25 25 25 25 25 25 25 25 25 25 25 25 25 25 25 25 105 25 25 25 25 25 25 25 25 25 25 25 25 25 25 25 25 25 67 67 67 25 25 67 25 25 25 25 25 
25 25 25 25 25 86 45 45 45 45 45 87 25 25 25 25 25 25 25 25 25 25 25 25 25 25 25 25 25 25 25 25 25 25 25 25 25 25 25 25 25 25 25 25 25 25 25 25 25 25 25 25 25 25 25 25 25 25 25 25 25 67 25 25 
25 25 25 25 25 26 0 0 0 0 0 44 45 45 45 45 45 45 45 45 45 45 45 45 45 45 45 45 45 45 45 45 45 45 45 45 45 45 45 45 45 87 25 25 25 25 25 25 25 25 25 25 25 105 25 25 25 25 25 25 25 67 67 25 
25 25 25 25 86 46 0 0 0 0 0 0 0 0 0 0 0 0 0 0 0 0 0 0 0 0 0 0 0 0 0 0 0 0 0 0 0 0 0 0 0 44 45 45 45 45 45 45 45 45 87 25 25 25 25 25 25 25 25 25 25 25 67 25 
25 25 25 25 26 0 0 0 0 0 0 0 0 0 0 0 0 0 0 0 0 0 0 0 0 0 0 0 14 0 0 0 0 0 0 0 0 0 0 0 0 0 0 0 0 0 0 0 0 0 44 45 45 45 45 87 25 25 25 25 25 25 25 25 
25 25 25 25 26 0 0 0 0 0 0 0 0 0 0 0 0 0 0 0 0 0 0 0 0 0 0 0 0 0 0 0 0 0 0 0 0 0 0 0 0 0 0 0 0 0 0 0 0 0 0 0 0 0 0 44 45 45 45 45 87 25 25 25 
25 25 25 86 46 0 0 0 0 0 0 0 0 0 0 0 0 0 0 0 0 0 0 0 0 0 0 0 0 0 0 0 0 0 0 0 0 0 0 0 0 0 0 0 0 0 0 0 0 14 0 0 0 0 0 0 0 0 0 0 24 25 25 25 
25 25 86 46 0 0 0 7 8 8 8 8 8 8 8 8 8 8 8 8 8 8 8 8 8 8 8 8 8 8 8 8 8 8 8 8 8 8 8 8 8 9 0 0 0 0 0 0 0 0 0 0 0 0 0 0 0 0 0 0 44 87 25 25 
25 86 46 0 0 0 0 27 60 60 60 60 60 60 60 60 60 60 60 60 60 60 60 60 60 60 60 60 60 60 60 60 60 60 60 60 60 60 60 60 60 110 9 0 0 0 0 0 0 0 0 0 0 0 0 0 0 0 0 0 0 24 25 25 
25 26 0 0 0 0 0 27 60 60 60 60 60 60 60 60 60 60 60 60 60 60 60 60 60 60 60 63 64 60 60 60 60 60 60 60 60 60 60 60 60 60 110 9 0 0 0 0 0 0 0 0 0 0 0 0 0 0 0 0 0 24 25 25 
25 106 6 0 0 0 0 27 60 60 60 60 60 60 60 60 60 60 60 60 60 60 60 60 60 60 60 83 84 60 60 60 60 60 60 60 63 64 60 60 60 60 60 29 0 0 0 14 0 0 0 0 0 0 15 0 0 0 0 0 0 24 25 25 
25 25 26 0 0 0 0 27 60 60 60 60 60 60 60 60 63 64 60 60 60 60 60 60 60 60 60 103 104 60 60 60 60 60 60 60 83 84 60 60 60 60 60 29 0 0 0 0 0 0 0 0 0 0 0 0 0 0 0 0 0 24 25 25 
25 25 26 0 0 0 0 27 60 60 60 63 64 60 60 60 83 84 60 60 63 64 60 60 63 64 60 60 60 60 60 60 14 60 60 60 103 104 60 60 60 60 60 110 9 0 0 0 0 0 0 0 0 0 0 0 0 0 0 0 0 24 25 25 
25 25 26 0 0 0 0 27 60 60 60 83 84 60 60 60 103 104 60 60 83 84 60 60 83 84 60 60 60 14 60 60 60 60 60 60 60 60 60 14 60 60 60 60 29 0 0 0 0 0 0 0 0 0 0 0 0 0 0 0 0 24 25 25 
105 25 26 0 0 0 0 47 91 60 60 103 104 60 60 60 60 60 60 60 103 104 60 60 103 104 60 60 60 63 64 60 14 60 60 60 60 60 60 60 60 60 60 60 29 0 0 0 0 0 0 0 0 0 0 0 0 0 0 0 0 24 25 25 
25 25 26 0 0 0 0 0 27 60 60 60 60 60 63 64 60 60 60 60 60 60 60 60 60 60 60 60 60 83 84 60 60 60 60 60 60 60 60 60 60 60 60 90 49 0 0 0 0 0 0 0 0 0 0 0 0 0 0 0 0 24 25 25 
25 25 26 0 0 0 0 0 27 60 60 60 60 60 83 84 60 60 60 60 60 60 60 60 60 60 60 60 60 103 104 60 60 60 60 63 64 60 60 60 60 60 60 29 0 0 0 0 0 0 0 0 0 0 0 0 0 0 0 0 0 24 25 25 
25 25 26 0 0 0 0 0 27 60 60 60 60 60 103 104 60 60 60 60 63 64 60 63 64 60 60 60 60 60 60 60 60 60 60 83 84 60 60 60 60 60 60 29 0 0 0 0 0 0 0 0 0 0 0 0 0 0 0 0 0 24 25 25 
25 25 26 0 0 0 0 0 47 91 60 60 60 60 60 60 60 60 60 60 83 84 60 83 84 60 60 60 60 60 60 60 60 60 60 103 104 60 60 60 60 60 90 49 0 0 0 0 0 0 0 0 0 0 0 0 0 0 0 0 0 24 25 25 
25 25 26 0 0 0 0 0 0 27 60 60 60 60 60 60 60 60 60 60 103 104 60 103 104 60 60 60 60 60 60 60 60 60 60 60 60 60 60 60 60 60 29 0 0 0 0 0 0 0 0 0 0 0 0 0 0 0 0 0 4 107 25 25 
25 25 26 0 0 0 0 0 0 47 48 48 91 60 60 60 60 60 60 60 60 60 60 60 60 60 60 60 60 60 60 60 60 60 60 60 60 60 60 60 60 90 49 0 0 0 0 0 0 0 0 0 0 0 0 0 0 0 0 0 24 25 25 25 
25 25 26 0 0 0 0 0 0 0 0 0 47 48 91 60 60 60 60 60 60 60 60 60 60 60 60 60 60 60 60 60 60 60 60 63 64 60 60 90 48 49 0 0 0 0 0 0 0 0 0 0 0 0 16 0 0 0 0 0 24 25 25 25 
25 25 26 0 0 0 0 0 0 0 0 0 0 0 47 91 60 60 60 90 48 48 48 48 48 48 48 48 48 48 91 60 60 60 60 83 84 60 90 49 0 0 0 0 0 0 0 0 0 0 0 0 0 0 0 0 0 0 0 0 24 25 25 25 
25 25 26 0 0 0 0 0 0 0 0 0 0 0 0 47 48 48 48 49 0 0 0 0 0 0 0 0 0 0 47 91 60 60 60 103 104 90 49 0 0 0 0 0 0 0 0 14 0 0 0 0 0 0 0 0 0 0 0 0 24 25 105 25 
25 25 26 0 0 0 0 0 0 0 0 0 0 0 0 0 0 0 0 0 0 0 0 0 0 0 0 0 0 0 0 47 91 60 60 60 90 49 0 0 0 0 0 0 0 0 0 0 0 0 0 0 0 0 0 0 0 0 0 0 24 25 25 25 
25 25 26 0 0 0 0 0 0 0 0 0 0 0 0 0 0 0 0 0 0 0 0 0 0 0 0 0 0 0 0 0 47 48 48 48 49 0 0 0 0 0 0 0 0 0 0 0 0 0 0 0 0 0 0 0 0 0 0 0 24 25 25 25 
25 25 26 0 0 0 0 0 0 0 0 0 0 0 0 0 0 0 0 0 0 0 0 0 0 0 0 0 0 0 0 0 0 0 0 0 0 0 0 0 0 0 0 0 0 0 0 0 0 0 0 0 0 0 0 0 0 0 0 0 24 25 25 25 
25 25 26 0 0 0 0 0 0 14 0 0 0 0 0 0 0 0 0 0 0 0 0 0 0 0 0 0 0 0 0 0 0 0 0 0 0 0 0 0 0 0 0 0 0 0 0 0 0 0 0 0 0 0 0 0 0 0 0 0 24 25 67 25 
25 25 26 0 0 0 14 0 0 0 0 0 0 0 0 0 0 0 0 0 0 0 0 0 0 0 0 0 0 0 0 0 0 0 0 0 0 0 0 0 0 0 0 0 14 0 0 0 0 0 0 0 0 0 0 0 0 0 0 0 24 25 25 25 
25 25 26 0 0 0 0 0 0 0 0 0 0 0 0 0 0 0 0 0 0 0 0 0 0 0 0 0 0 0 0 0 0 0 0 0 0 0 0 0 0 0 0 0 0 0 0 0 0 0 0 0 0 0 0 0 0 0 0 0 24 25 67 67 
25 25 26 0 0 0 0 0 0 0 0 0 0 0 0 0 14 0 0 0 0 0 0 0 0 0 0 0 0 0 0 0 0 0 0 0 0 0 0 0 0 0 0 0 0 0 0 0 0 0 0 0 0 0 0 0 16 0 0 0 24 25 25 67 
25 25 26 0 0 0 0 0 0 0 0 0 0 0 0 0 0 0 0 0 0 0 0 0 0 0 0 0 0 0 0 0 0 0 0 0 0 0 0 0 0 0 0 0 0 0 0 0 0 0 0 0 0 0 0 0 0 0 0 0 24 25 25 67 
25 25 26 0 0 0 0 0 0 0 0 0 0 0 0 0 0 0 0 0 0 0 0 0 0 0 0 0 0 0 0 0 0 0 0 0 0 14 0 0 0 0 0 0 0 0 0 0 0 0 0 0 0 0 0 0 0 0 0 0 24 25 25 25 
25 25 26 0 0 0 0 0 0 0 74 0 0 0 0 0 0 0 0 0 0 0 0 0 0 0 0 0 0 0 0 0 0 0 0 0 0 0 0 0 0 0 0 0 0 0 0 0 0 0 0 0 0 0 0 0 0 0 0 0 24 25 25 25 
25 25 26 0 0 0 0 0 0 0 0 0 0 0 0 0 0 0 0 0 0 0 0 0 0 0 0 0 0 0 0 0 0 0 0 85 0 0 0 0 0 0 0 0 0 0 0 0 0 0 0 0 0 0 0 0 0 0 0 0 24 25 25 25 
25 25 26 0 0 0 0 0 0 0 0 0 0 0 0 0 0 0 0 0 0 85 85 85 0 0 0 0 0 0 0 0 0 0 85 85 0 0 0 0 0 0 0 0 0 0 0 0 0 0 0 0 0 0 0 0 0 0 0 0 24 25 25 25 
25 25 26 0 0 0 0 0 0 0 0 0 0 0 0 0 0 0 0 0 0 0 0 85 85 0 0 0 0 0 0 0 0 0 85 85 0 0 0 0 0 0 0 16 0 0 0 0 0 0 0 0 0 0 0 0 0 0 0 0 24 25 25 25 
25 25 26 65 65 65 65 65 65 65 65 0 0 0 0 0 0 0 0 0 0 0 0 0 85 114 115 115 115 115 115 115 115 116 0 85 0 0 0 0 0 0 0 0 0 0 0 0 0 0 0 0 0 0 0 0 0 0 0 0 24 25 25 25 
25 25 26 65 61 62 63 64 61 62 65 65 65 65 0 0 0 0 0 0 0 0 0 0 0 0 0 0 0 0 0 0 0 0 0 85 0 0 0 0 0 0 0 0 0 0 0 0 0 0 0 0 0 0 0 0 0 0 0 0 24 25 25 25 
25 25 26 65 81 82 83 84 81 82 65 61 62 65 0 0 0 0 0 0 0 0 0 0 0 0 0 0 0 0 0 0 0 0 0 0 0 0 0 0 0 0 0 0 0 0 0 0 0 0 0 0 0 0 0 0 0 0 0 0 24 25 25 25 
25 25 26 65 101 102 103 104 101 102 0 81 82 65 0 0 0 0 0 0 0 0 0 0 0 0 0 0 0 0 0 0 0 0 0 0 0 0 0 0 0 0 0 0 0 0 0 0 0 0 0 0 0 0 0 0 0 0 0 0 24 25 25 25 
25 25 26 65 65 63 64 65 61 62 0 101 102 65 65 0 0 0 0 0 0 0 0 0 0 0 0 0 0 0 0 0 0 0 0 0 0 0 0 0 0 0 0 0 0 0 0 0 0 0 0 0 0 0 0 0 0 0 0 0 24 25 25 105 
25 25 26 0 65 83 84 0 81 82 0 0 63 64 65 65 65 65 65 0 0 0 0 0 0 0 0 0 0 0 0 0 0 0 0 0 0 0 0 0 0 0 0 0 0 0 0 0 0 0 0 0 0 0 0 0 0 0 0 0 24 25 25 25 
25 25 26 0 0 103 104 65 101 102 61 62 83 84 65 65 61 62 65 0 0 0 0 0 0 0 0 0 0 0 0 0 0 0 0 0 0 0 0 0 0 0 0 0 0 0 0 0 0 0 0 0 0 0 0 0 0 0 0 0 24 25 25 25 
25 25 26 65 0 0 61 62 0 0 81 82 103 104 61 62 81 82 65 65 65 0 0 0 0 0 0 0 0 0 0 0 0 17 0 0 0 0 0 0 0 0 0 0 0 0 0 0 0 0 0 0 0 0 0 0 17 0 0 0 24 25 25 25 
25 25 26 65 0 65 81 82 0 0 101 102 65 65 81 82 101 102 61 62 65 0 0 0 0 0 0 0 0 0 0 0 0 0 0 0 0 0 0 0 7 8 8 8 8 8 8 8 8 8 8 8 8 8 8 9 0 0 0 0 24 25 25 25 
105 25 26 65 61 62 63 64 63 64 65 63 64 0 101 102 65 65 81 82 65 0 0 0 0 0 0 0 0 0 0 0 0 0 0 0 0 0 0 0 27 85 60 60 60 60 60 60 60 60 60 60 60 60 60 29 0 0 0 0 24 25 25 25 
25 25 26 65 81 82 83 84 83 84 0 83 84 0 63 64 65 65 101 102 65 65 65 0 0 0 0 0 0 0 0 0 0 0 0 0 0 0 0 0 27 60 85 60 60 60 60 60 60 60 60 60 60 85 60 29 0 0 0 0 24 25 25 25 
25 25 26 65 101 102 103 104 103 104 65 103 104 65 83 84 65 61 62 65 61 62 65 61 62 0 0 0 0 0 0 0 0 0 0 0 0 0 0 0 27 60 60 60 60 85 60 60 60 60 60 60 60 60 60 29 0 0 0 0 24 25 25 25 
25 25 26 65 61 62 65 65 61 62 0 0 0 0 103 104 0 81 82 65 81 82 65 81 82 65 0 0 0 0 0 0 0 0 0 0 0 0 0 0 27 60 60 60 60 60 60 60 60 60 60 60 85 60 60 29 0 0 0 0 24 25 25 25 
25 25 26 65 81 82 61 62 81 82 0 0 0 0 65 65 0 101 102 65 101 102 65 101 102 65 65 65 0 0 0 0 0 0 0 0 0 0 0 0 27 60 60 60 60 60 60 114 115 116 60 60 60 60 60 29 0 0 0 0 24 25 25 25 
25 25 26 0 101 102 81 82 101 102 0 0 0 0 61 62 65 65 0 0 65 65 61 62 65 61 62 63 64 0 0 0 0 0 0 0 0 0 0 0 27 60 60 85 60 60 60 60 60 60 60 60 60 60 60 29 0 0 0 0 24 25 25 67 
25 25 26 0 61 62 101 102 61 62 65 63 64 65 81 82 65 65 0 0 0 65 81 82 65 81 82 83 84 0 0 0 0 0 0 0 0 0 0 0 27 60 85 60 60 60 60 60 85 60 60 60 60 85 60 29 0 0 0 0 24 25 25 67 
25 25 26 0 81 82 61 62 81 82 0 83 84 65 101 102 65 61 62 65 61 62 101 102 65 101 102 103 104 65 0 0 0 0 0 0 0 0 0 0 27 60 60 60 60 60 60 60 60 60 60 60 60 60 60 29 0 0 0 0 24 25 25 25 
25 25 26 65 101 102 81 82 101 102 0 103 104 65 65 61 62 81 82 65 81 82 65 65 61 62 65 63 64 65 0 0 74 0 0 0 0 0 0 0 47 48 48 48 48 48 48 48 48 48 48 48 48 48 48 49 0 0 0 0 24 25 25 25 
25 25 26 65 61 62 61 62 63 64 65 65 65 63 64 81 82 101 102 65 101 102 65 65 81 82 65 83 84 65 0 0 0 0 0 0 0 0 17 0 0 0 0 0 0 0 0 0 0 0 0 0 0 0 0 0 0 0 0 0 24 25 25 25 
67 25 26 65 81 82 81 82 83 84 61 62 0 83 84 101 102 61 62 65 65 63 64 65 101 102 65 103 104 85 0 0 0 0 0 0 0 0 0 0 0 0 0 56 0 0 0 0 0 0 0 0 0 0 0 0 0 0 0 0 24 25 25 25 
25 25 26 65 101 102 101 102 103 104 81 82 65 103 104 0 0 81 82 0 65 83 84 63 64 63 64 65 65 85 0 0 0 0 0 0 0 0 0 0 0 0 0 0 0 0 0 0 0 0 0 0 0 0 0 0 0 0 0 0 24 25 25 25 
25 25 26 65 61 62 63 64 65 65 101 102 0 65 65 0 65 101 102 65 65 103 104 83 84 83 84 65 65 85 0 0 0 0 0 0 0 0 0 0 0 0 0 0 0 0 0 0 0 0 0 0 0 0 0 0 0 0 0 0 24 25 25 25 
25 25 26 65 81 82 83 84 0 0 65 65 0 65 65 65 65 65 65 65 65 65 65 103 104 103 104 65 4 5 5 5 5 5 5 5 5 5 5 5 5 5 5 5 5 5 5 5 6 0 0 0 0 0 0 0 0 0 0 0 24 25 25 25 
25 25 26 65 101 102 103 104 65 65 65 4 5 5 5 5 5 5 5 5 5 5 5 5 5 5 5 5 107 25 25 25 25 25 25 25 25 25 25 25 25 25 25 25 25 25 25 25 106 5 5 5 5 5 5 5 5 5 5 5 107 25 105 25 
25 25 106 5 5 5 5 5 5 5 5 107 25 25 25 25 25 25 25 25 25 25 25 25 25 25 25 25 25 25 25 67 25 25 25 25 25 25 25 25 25 25 25 25 25 25 25 25 25 25 25 25 25 25 25 25 25 25 25 25 25 25 25 25 
25 25 25 25 25 25 25 25 25 25 25 25 25 25 25 25 25 25 25 105 25 25 25 25 25 25 25 25 25 25 25 25 25 25 25 67 25 25 25 25 25 25 105 25 25 25 25 25 25 25 25 25 25 25 67 67 67 67 67 67 67 67 67 67