283 283 283 283 283 283 283 283 283 283 283 283 283 283 283 283 283 283 283 283 283 283 283 283 283 283 283 283 283 283 283 283 283 283 283 283 283 283 283 283 283 283 283 283 283 283 283 283 283 283 283 283 283 283 283 283 283 283 283 283 283 283 283 283 
283 283 303 303 303 303 303 303 303 303 303 303 303 303 303 303 303 303 303 303 303 303 303 303 303 303 303 303 303 303 303 303 303 303 303 303 303 303 303 303 303 303 303 303 303 303 303 303 303 303 303 303 303 303 303 303 303 303 303 303 303 303 283 283 
283 284 0 0 0 0 0 0 0 0 0 0 0 0 0 0 0 0 0 0 0 0 0 0 0 0 0 0 0 0 0 0 0 0 0 0 0 0 0 0 0 0 0 0 0 0 0 0 0 0 0 0 0 0 0 0 0 0 0 0 0 0 282 283 
283 284 0 0 0 0 0 262 263 263 263 263 263 263 263 263 263 263 263 263 263 264 0 0 0 0 0 0 0 0 0 261 0 0 0 0 0 0 0 0 0 0 0 0 0 0 0 0 0 0 0 0 0 0 0 0 0 0 0 0 0 0 282 283 
283 284 0 0 0 262 263 282 303 303 303 303 303 303 303 303 303 283 283 283 283 284 264 0 0 0 0 0 0 0 0 281 0 0 0 0 0 0 0 0 0 0 0 0 0 0 0 0 0 0 0 0 262 263 263 263 263 264 0 0 0 0 282 283 
283 284 0 0 0 282 303 304 0 0 0 0 0 0 0 0 262 282 40 40 40 283 284 264 0 0 0 0 0 0 0 281 263 263 263 264 0 0 0 0 0 0 0 0 262 263 263 263 263 263 263 263 282 303 303 303 303 284 0 0 0 0 282 283 
283 284 0 0 0 281 0 0 0 0 0 0 0 0 0 0 282 283 40 40 40 40 283 284 0 0 0 0 0 0 0 302 303 303 303 284 0 0 0 0 0 0 0 0 302 303 303 303 303 303 303 303 284 0 0 0 0 281 0 0 0 0 282 283 
283 284 0 0 0 281 0 0 0 0 0 0 0 0 0 0 302 303 283 40 40 40 40 284 264 0 0 0 0 0 0 0 0 0 0 281 264 0 0 0 0 0 0 0 0 0 0 0 0 0 0 0 301 0 0 0 0 281 0 0 0 0 282 283 
283 284 0 0 0 301 0 19 0 0 0 0 0 0 0 0 0 0 302 283 40 40 40 283 284 0 0 0 0 0 0 0 0 0 0 302 304 0 0 0 0 0 0 0 0 0 0 0 0 0 0 0 0 0 0 0 0 281 0 0 0 0 282 283 
283 284 0 0 0 0 0 0 0 0 0 0 0 0 0 262 264 0 0 302 283 40 40 40 284 263 264 0 0 0 0 0 0 0 0 0 0 0 0 0 0 0 0 0 0 0 0 0 0 0 0 0 0 0 0 0 0 281 0 0 0 0 282 283 
283 284 0 0 0 0 262 263 263 263 263 263 263 263 263 282 284 0 0 0 302 283 40 40 283 283 284 0 0 0 0 0 0 0 0 0 0 0 19 19 19 0 0 0 0 0 0 262 263 264 0 0 0 0 0 0 0 281 0 0 0 0 282 283 
283 284 0 0 0 0 282 283 283 283 283 283 283 283 283 283 284 0 0 0 0 282 40 40 40 40 284 0 262 263 263 263 263 263 263 264 0 0 0 0 19 0 0 0 0 0 0 282 303 284 263 264 0 0 0 0 0 281 0 0 0 0 282 283 
283 284 0 0 0 0 282 40 40 40 40 40 40 40 40 283 284 0 0 0 0 302 283 40 40 283 304 0 302 303 303 303 303 303 303 304 0 0 0 0 0 20 19 19 19 0 0 281 0 302 303 304 0 0 0 0 0 281 0 0 0 0 282 283 
283 284 0 0 0 0 302 283 40 40 40 40 40 40 40 283 284 0 0 0 0 0 282 40 40 284 0 0 0 0 0 0 0 0 0 0 0 0 0 0 0 0 0 0 0 0 0 281 0 0 0 0 0 0 0 0 0 281 0 0 0 0 282 283 
283 284 0 0 0 0 0 302 283 40 40 40 40 40 40 283 284 0 0 0 0 19 282 40 283 304 0 262 263 263 263 263 264 0 0 0 0 0 261 0 0 0 0 0 0 0 0 281 0 0 0 0 0 0 0 0 0 281 0 0 0 0 282 283 
283 284 263 264 0 0 0 0 282 40 40 40 40 40 40 283 284 0 0 0 19 20 282 303 304 0 262 282 303 303 303 303 304 0 0 0 0 0 281 0 0 0 0 0 0 0 0 281 0 0 0 0 0 0 0 0 0 281 0 0 20 0 282 283 
283 283 283 284 0 0 0 0 302 283 40 40 40 40 40 283 284 0 0 19 20 283 304 0 0 262 282 304 0 0 0 0 0 0 0 0 0 262 281 0 0 0 0 0 0 0 0 281 0 0 0 0 0 0 0 0 0 281 0 0 0 0 282 283 
283 283 40 284 263 264 0 0 0 302 283 40 40 40 40 283 284 19 19 20 283 304 0 0 0 282 304 0 0 0 0 0 0 0 0 262 263 282 304 0 0 0 0 0 0 0 0 281 0 0 0 0 0 0 0 0 0 281 0 0 0 0 282 283 
283 283 40 283 283 284 264 0 0 0 302 283 40 40 40 283 284 19 20 283 304 0 0 0 262 281 0 0 0 0 0 0 262 263 263 282 283 304 0 0 0 0 0 0 0 0 0 281 0 0 0 0 0 0 0 0 0 281 0 0 0 0 282 283 
283 283 40 40 40 283 284 0 0 0 0 302 283 40 40 283 284 20 20 284 0 0 0 262 282 304 0 0 0 0 0 0 302 303 303 304 0 0 0 0 0 0 0 262 263 263 263 281 263 263 263 263 263 263 263 263 263 281 0 0 0 0 282 283 
283 283 40 40 40 40 284 263 264 0 0 0 302 283 40 283 284 20 283 304 0 0 0 282 304 0 0 0 0 0 0 0 0 0 0 0 0 0 0 0 0 0 0 302 303 303 303 303 303 303 303 303 303 303 303 303 303 284 0 0 0 0 282 283 
283 283 40 40 40 40 283 283 284 264 0 0 0 302 283 283 283 283 304 0 0 0 262 281 0 0 0 0 0 0 0 0 0 0 0 19 19 19 0 0 0 0 0 0 0 0 0 0 0 0 0 0 0 0 0 0 0 281 0 0 0 0 282 283 
283 283 283 40 40 40 40 40 283 284 264 0 0 0 302 283 284 0 0 0 0 262 282 304 0 0 0 0 0 0 0 0 0 0 0 0 0 0 0 0 0 0 0 0 0 0 0 0 0 0 0 0 0 0 0 0 0 281 0 0 0 0 282 283 
283 283 303 283 40 40 40 40 40 283 284 263 264 0 0 282 284 0 0 262 263 282 304 0 0 0 0 0 0 0 0 0 0 262 263 263 263 263 264 0 0 0 0 0 0 0 0 0 0 0 0 0 0 0 0 0 0 281 0 0 0 0 282 283 
283 284 0 302 283 40 40 40 40 40 40 283 284 264 0 302 304 0 262 282 304 0 0 0 0 0 0 19 0 0 0 262 263 282 283 283 283 283 284 264 0 0 0 0 0 0 262 264 0 0 0 0 0 0 0 0 0 281 0 0 0 0 282 283 
283 284 0 0 302 303 40 40 40 40 40 40 283 283 0 0 0 0 282 304 0 0 0 0 0 19 0 0 0 0 262 282 283 283 40 40 40 40 283 284 264 0 0 0 0 0 282 284 0 0 0 0 0 0 0 0 0 281 0 0 0 0 282 283 
283 284 0 0 0 0 302 283 40 40 40 40 40 284 0 0 0 0 281 0 0 0 0 0 0 0 0 0 0 262 282 283 40 40 40 40 40 40 40 283 284 0 0 0 0 0 282 284 0 0 0 0 0 0 0 0 0 281 0 0 0 0 282 283 
283 284 0 0 0 0 0 302 283 40 40 40 40 284 0 0 0 0 281 0 0 0 0 0 0 0 0 0 0 282 283 40 40 40 40 40 40 40 40 40 284 264 0 0 0 0 282 284 0 0 0 0 0 0 0 0 0 281 0 0 0 0 282 283 
283 284 0 0 0 0 0 0 302 283 40 40 40 284 0 0 0 0 281 0 0 0 20 0 0 0 0 0 262 282 40 40 40 40 40 40 40 40 40 40 283 284 0 0 0 0 282 284 0 0 0 0 0 0 0 0 0 281 0 0 0 0 282 283 
283 284 0 0 0 0 0 0 0 302 283 40 40 284 0 0 0 0 281 0 0 0 0 0 0 0 0 0 282 283 40 40 40 40 40 40 40 40 40 40 40 284 0 0 0 0 282 284 0 0 0 0 0 0 0 0 0 281 0 0 0 0 282 283 
283 284 0 0 0 0 0 0 0 0 282 40 40 284 0 0 0 0 281 0 0 0 0 0 0 0 0 0 282 40 40 40 40 40 40 40 40 40 40 40 40 284 0 0 0 0 282 284 0 0 0 0 0 0 0 0 0 281 0 0 0 0 282 283 
283 284 0 0 0 0 0 0 0 0 302 303 303 304 0 0 0 0 281 264 0 0 0 0 0 0 0 0 282 40 40 40 40 40 40 40 40 40 40 40 40 284 0 0 0 0 282 284 0 0 0 0 20 0 0 0 0 281 0 0 0 0 282 283 
283 284 0 0 0 0 0 0 0 0 0 0 0 0 0 0 0 0 282 284 263 263 264 0 0 0 0 0 302 283 283 40 40 40 40 40 40 40 40 40 40 284 0 0 0 0 282 284 0 0 0 0 0 0 0 0 0 281 0 0 0 0 282 283 
283 284 0 0 0 0 20 0 0 0 0 0 0 0 0 0 0 0 282 283 283 283 284 264 0 0 0 0 0 0 283 40 40 40 40 40 40 40 40 40 283 304 0 0 0 0 282 284 0 0 0 0 0 0 0 0 0 281 0 0 0 0 282 283 
283 284 0 0 0 0 262 263 263 263 263 263 263 264 0 0 0 0 282 40 40 40 283 284 0 0 0 0 0 0 302 283 283 40 40 40 40 40 40 283 304 0 0 0 0 0 282 284 0 0 0 0 0 262 263 263 263 281 0 0 0 0 282 283 
283 284 0 0 0 0 282 283 283 283 283 283 283 284 0 0 0 0 282 40 40 40 40 284 264 0 0 0 0 0 0 0 302 303 303 303 303 303 303 304 0 0 0 0 0 0 282 284 0 0 0 0 0 302 303 303 303 304 0 0 0 0 282 283 
283 284 0 0 0 262 282 40 40 40 40 40 40 284 0 0 0 0 282 40 40 40 40 283 284 264 0 0 0 0 0 0 0 0 0 0 0 0 0 0 0 0 0 0 0 0 282 284 0 0 0 0 0 0 0 0 0 0 0 0 0 0 282 283 
283 284 0 262 263 282 283 40 40 40 40 40 40 284 0 0 0 0 282 40 40 40 40 40 283 284 263 264 0 0 0 0 0 0 0 0 19 0 0 0 0 0 0 0 0 0 282 284 0 0 0 0 0 0 0 0 0 0 0 0 0 0 282 283 
283 284 263 282 283 283 40 40 40 40 40 40 40 284 0 0 0 0 282 40 40 40 40 40 40 283 283 284 0 0 0 0 0 0 0 19 19 19 0 0 0 0 0 0 0 0 282 284 0 0 0 0 0 262 263 263 263 263 264 0 0 0 282 283 
283 283 283 283 40 40 40 40 40 40 40 40 40 284 0 0 0 0 282 40 40 40 40 40 40 40 40 284 0 0 0 0 0 0 0 0 19 0 0 0 0 0 0 0 0 262 282 284 264 0 0 0 0 302 303 303 303 303 284 0 0 0 282 283 
283 283 40 40 40 40 40 40 40 40 40 40 40 284 0 0 0 0 282 40 40 40 40 40 40 40 40 284 264 0 0 0 0 0 0 0 19 0 0 0 0 0 0 0 262 282 303 303 284 264 0 0 0 0 0 0 0 0 281 0 0 0 282 283 
283 283 40 40 40 40 40 40 40 40 40 40 40 284 0 0 0 0 282 40 40 40 40 40 40 40 40 283 284 0 0 0 0 0 0 0 19 0 0 0 0 0 0 262 282 304 0 0 302 284 264 0 0 0 0 0 0 0 281 0 0 0 282 283 
283 283 40 40 40 40 40 40 40 40 40 40 40 284 0 0 0 0 282 40 40 40 40 40 40 40 40 40 284 0 0 0 0 0 0 0 0 0 0 0 0 0 262 282 304 0 0 0 0 302 284 264 0 0 0 0 0 0 281 0 0 0 282 283 
283 283 40 40 40 40 40 40 40 40 40 40 40 284 0 0 0 0 282 40 40 40 40 40 40 40 40 40 284 263 263 263 263 264 0 0 0 0 0 0 0 262 282 304 0 0 0 0 0 0 302 284 264 0 0 0 0 0 281 0 0 0 282 283 
283 283 40 40 40 40 40 40 40 40 40 40 40 284 0 0 0 0 282 40 40 40 40 40 40 40 40 40 283 283 283 283 283 284 264 0 0 0 0 0 262 282 304 0 0 0 0 0 0 0 0 302 284 264 0 0 0 0 281 0 0 0 282 283 
283 283 40 40 40 40 40 40 40 40 40 40 40 284 264 0 0 0 282 40 40 40 40 40 40 40 40 40 40 40 40 40 40 283 284 0 0 0 0 262 282 304 0 0 0 0 0 0 0 0 0 0 302 284 264 0 0 0 281 0 0 0 282 283 
283 283 40 40 40 40 40 40 40 40 40 40 40 283 284 0 0 0 302 303 303 303 303 303 303 303 303 303 303 303 303 303 303 303 304 0 0 0 0 302 304 0 0 0 0 0 0 0 0 0 0 0 0 302 304 0 0 0 301 0 0 0 282 283 
283 283 303 303 303 303 303 303 303 303 303 303 303 303 304 0 0 0 0 0 0 0 0 0 0 0 0 0 0 0 0 0 0 0 0 0 0 0 0 0 0 0 0 0 0 0 0 0 20 0 0 0 0 0 0 0 0 0 0 0 0 0 282 283 
283 284 0 0 0 0 0 0 0 0 0 0 0 0 0 0 0 0 0 0 0 0 0 0 0 0 0 0 0 0 0 0 0 0 20 0 0 0 0 0 0 0 0 0 0 0 0 0 0 0 0 0 0 0 0 0 0 0 0 0 0 0 282 283 
283 284 0 0 0 0 0 0 0 0 0 0 0 0 20 0 0 0 0 0 0 0 0 0 0 0 0 0 0 0 0 0 0 0 0 0 0 0 0 262 264 0 0 0 261 0 0 0 0 0 0 0 0 0 0 0 0 0 0 0 0 0 282 283 
283 284 263 263 263 263 263 263 263 263 263 263 263 264 0 0 0 0 262 263 263 263 263 263 263 263 263 263 263 263 263 263 263 263 263 263 263 263 263 282 304 0 0 0 281 263 263 263 263 263 263 263 263 263 263 263 263 263 263 263 263 263 282 283 
283 283 283 283 283 283 283 283 283 283 283 283 283 284 0 0 0 0 282 303 303 303 303 303 303 303 303 303 303 303 303 303 303 303 303 303 303 303 303 304 0 0 0 262 282 303 303 303 303 303 303 303 303 303 303 303 303 303 303 303 303 303 283 283 
283 283 40 40 40 40 40 40 40 40 40 40 40 284 0 0 0 0 281 0 0 0 0 0 0 0 0 0 0 0 0 0 0 0 0 0 0 0 0 0 0 0 262 282 304 0 0 0 0 0 0 0 0 0 0 0 0 0 0 0 0 0 282 283 
283 283 40 40 40 40 40 40 40 40 40 40 40 284 0 0 0 0 281 0 0 0 0 0 0 0 0 0 0 0 0 0 0 262 263 263 264 0 0 0 0 0 302 304 0 0 0 0 0 0 0 0 0 0 0 0 0 0 0 0 0 0 282 283 
283 283 40 40 40 40 40 40 40 40 40 40 40 284 0 0 0 0 281 0 0 0 0 0 0 0 0 0 0 0 0 0 0 282 283 283 284 0 0 0 0 0 0 0 0 0 0 0 0 0 0 0 0 0 0 0 0 0 0 0 0 0 282 283 
283 283 40 40 40 40 40 40 40 40 40 40 40 284 0 0 19 0 281 0 0 0 0 0 0 0 0 0 0 20 0 0 262 282 40 40 284 0 0 0 0 0 0 0 0 0 0 0 0 0 0 0 0 0 0 0 0 0 0 0 0 0 282 283 
283 283 40 40 40 40 40 40 40 40 40 40 40 284 0 0 0 0 281 263 263 263 263 264 0 0 0 0 0 0 0 262 282 283 40 40 284 263 263 263 263 264 0 0 0 0 0 0 0 0 0 0 0 0 0 0 262 263 263 263 263 263 282 283 
283 283 40 40 40 40 40 40 40 40 40 40 40 284 0 0 0 0 302 303 303 303 303 284 264 0 0 0 0 0 0 282 283 40 40 40 283 283 283 283 283 284 264 0 0 0 0 0 0 0 0 0 0 0 0 262 282 303 303 303 303 303 283 283 
283 283 40 40 40 40 40 40 40 40 40 40 40 284 0 0 0 0 0 0 0 0 0 302 284 264 0 0 0 0 0 282 40 40 40 40 283 40 40 40 40 283 284 0 0 0 20 20 0 0 0 0 262 263 263 282 304 0 0 0 0 0 282 283 
283 283 40 40 40 40 40 40 40 40 40 40 40 284 0 0 0 0 0 0 0 0 0 0 302 304 0 0 0 262 263 282 40 40 40 40 283 40 40 40 40 40 284 0 0 0 19 20 19 0 0 261 302 303 303 304 0 19 0 20 20 0 282 283 
283 283 40 40 40 40 40 40 40 40 40 40 40 284 0 0 0 0 0 0 0 0 0 0 0 0 0 0 262 282 283 283 40 40 40 40 283 40 40 40 40 40 284 0 0 0 0 20 0 0 0 301 0 19 19 0 19 19 0 20 20 0 282 283 
283 283 40 40 40 40 40 40 40 40 40 40 40 284 263 263 263 263 263 263 263 263 263 263 263 263 263 263 282 283 283 40 40 40 40 40 283 40 40 40 40 40 284 263 263 263 263 263 263 263 263 263 263 264 19 19 19 0 0 0 0 0 282 283 
283 283 283 283 283 283 283 283 283 283 283 283 283 283 283 283 283 283 283 283 283 283 283 283 283 283 283 283 283 283 283 283 283 283 283 283 283 283 283 283 283 283 283 283 283 283 283 283 283 283 283 283 283 283 283 283 283 283 283 283 283 283 283 283 
283 283 283 283 283 283 283 283 283 283 283 283 283 283 283 283 283 283 283 283 283 283 283 283 283 283 283 283 283 283 283 283 283 283 283 283 283 283 283 283 283 283 283 283 283 283 283 283 283 283 283 283 283 283 283 283 283 283 283 283 283 283 283 283