36 36 36 36 36 36 36 36 36 36 36 36 36 36 36 36 36 36 36 36 36 36 36 36 36 36 36 36 36 36 36 36 36 36 36 36 36 36 36 36 36 36 36 36 36 36 36 36 36 36 36 36 36 36 36 36 36 36 36 36 36 36 36 36 
36 36 36 36 36 7 8 8 8 8 8 8 8 9 36 36 36 36 7 8 8 8 8 8 8 8 8 8 8 8 8 9 36 36 36 36 36 7 8 8 8 8 8 8 8 8 8 8 8 8 8 8 8 8 8 8 8 9 36 36 36 36 36 36 
36 36 36 36 7 54 11 11 11 11 11 11 11 53 8 8 8 8 54 11 11 11 11 11 11 11 11 11 11 11 11 53 8 8 8 8 8 54 11 11 11 11 11 11 11 11 11 28 29 30 11 11 11 11 11 11 11 53 9 36 36 36 36 36 
36 36 36 7 54 11 11 11 11 11 11 11 11 11 11 11 44 45 11 11 11 11 11 11 11 11 11 11 11 11 11 11 11 11 11 11 11 11 11 11 11 11 11 11 11 11 11 37 38 39 11 11 11 11 28 29 30 11 53 8 9 36 36 36 
36 36 36 16 11 28 29 30 11 11 11 11 11 11 11 44 21 19 20 20 20 20 20 20 20 20 20 20 45 44 45 11 11 11 11 11 11 11 11 11 11 11 11 11 44 45 11 46 47 48 11 11 11 11 37 38 39 11 11 11 53 9 36 36 
36 36 7 54 11 37 38 39 11 11 11 11 11 11 11 53 3 1 2 2 2 2 2 2 2 2 2 3 19 21 19 45 11 11 11 11 11 11 11 11 11 11 11 44 21 19 45 11 11 11 11 11 11 11 46 47 48 11 11 11 11 18 36 36 
36 36 16 11 11 46 47 48 11 11 11 17 17 11 11 17 53 54 11 17 11 11 11 11 11 11 11 53 2 3 1 54 11 11 11 11 28 29 30 11 11 11 11 53 3 1 54 11 11 11 11 11 11 11 11 11 11 11 11 11 11 53 9 36 
36 36 16 11 11 11 11 11 11 11 17 17 11 11 11 11 11 11 11 11 11 11 11 11 11 11 11 11 17 12 10 11 11 17 17 11 37 38 39 11 11 11 11 17 53 54 11 11 11 11 11 11 44 45 11 11 11 11 11 11 11 11 18 36 
36 7 54 11 11 11 11 11 17 17 11 11 11 11 11 11 11 11 11 11 11 11 11 11 11 11 11 11 11 12 10 17 17 11 11 11 46 47 48 11 11 11 17 17 11 11 11 11 11 11 11 44 21 19 45 11 11 11 11 11 11 11 18 36 
36 16 11 11 11 44 45 11 17 11 11 11 11 11 11 11 11 11 11 11 11 11 11 11 11 11 11 11 44 21 10 17 11 11 11 11 11 11 11 11 11 17 17 11 11 11 11 11 11 11 17 53 3 1 54 11 11 11 11 11 11 11 18 36 
36 16 11 11 44 21 19 45 17 17 7 8 8 8 8 8 8 8 8 9 11 11 11 11 11 11 11 11 12 1 54 17 17 11 11 11 11 11 11 11 7 8 8 8 8 8 8 8 8 9 17 17 53 54 11 11 11 11 11 11 11 11 18 36 
36 16 11 11 53 3 1 54 11 17 16 7 8 8 8 8 8 8 9 18 11 11 11 11 11 11 11 44 21 19 45 11 17 17 11 11 11 11 11 11 16 7 8 8 8 8 8 8 9 18 17 17 11 11 11 11 28 29 30 11 11 11 18 36 
36 16 11 11 17 53 54 11 11 11 16 16 17 17 11 11 17 17 18 18 11 11 11 11 11 11 11 53 3 1 54 11 11 17 17 11 17 11 17 11 16 16 17 17 11 11 17 17 18 18 11 17 17 11 11 11 37 38 39 11 11 11 18 36 
36 16 11 11 28 29 30 17 11 11 16 16 17 7 8 8 9 17 18 18 11 11 11 11 40 40 40 40 21 10 11 11 11 17 17 11 17 17 17 17 16 16 17 7 8 8 9 17 18 18 11 11 17 17 11 17 46 47 48 11 11 11 18 36 
36 16 11 11 37 38 39 17 11 11 16 16 17 16 17 17 18 17 18 18 11 11 11 40 33 33 33 33 33 10 17 11 11 28 29 30 17 17 17 17 16 16 17 16 17 17 18 17 18 18 11 11 17 28 29 30 17 11 11 11 11 11 18 36 
36 16 11 11 46 47 48 17 11 11 16 16 17 16 17 17 18 17 18 18 11 11 11 40 33 33 33 33 33 10 17 11 11 37 38 39 17 17 17 17 16 16 17 16 17 17 18 17 18 18 11 11 17 37 38 39 17 11 11 11 11 11 18 36 
36 16 11 11 11 11 17 17 11 11 16 16 17 25 26 26 27 17 18 18 11 11 40 33 33 33 33 33 33 10 17 11 11 46 47 48 17 17 17 17 16 16 17 25 26 26 27 17 18 18 11 11 17 46 47 48 17 11 11 11 11 11 18 36 
36 16 11 11 11 11 17 17 11 11 16 16 17 17 11 11 17 11 18 18 11 11 40 33 33 33 33 33 33 10 17 11 11 17 17 11 17 17 17 17 16 16 17 17 11 11 17 11 18 18 11 11 17 17 11 17 17 11 11 11 11 11 18 36 
36 16 11 11 11 11 17 17 11 11 16 25 26 26 26 26 26 26 27 18 11 11 40 33 33 33 33 33 33 40 17 11 11 17 11 11 17 17 17 17 16 25 26 26 26 26 26 26 27 18 11 11 17 17 11 17 17 11 11 11 11 11 18 36 
36 16 11 44 45 11 11 11 11 11 25 26 26 26 26 26 26 26 26 27 11 11 11 40 33 33 33 33 33 40 11 11 11 11 11 11 11 11 11 11 25 26 26 26 26 26 26 26 26 27 11 11 17 11 11 17 17 11 11 11 11 11 18 36 
36 16 44 21 19 45 11 11 11 11 17 17 11 11 11 11 11 11 11 11 11 11 11 11 40 40 40 40 40 40 11 11 11 17 17 11 11 11 11 11 11 11 11 11 17 17 11 11 11 11 11 11 11 11 44 45 11 11 11 11 11 11 18 36 
36 16 53 3 1 54 11 11 11 17 17 17 17 11 11 11 11 11 11 11 11 11 11 11 17 17 11 11 11 11 11 11 44 45 11 17 11 11 11 11 11 11 11 17 11 11 11 11 11 11 17 17 11 44 21 19 45 11 11 11 11 11 18 36 
36 16 17 53 54 11 11 11 17 17 11 17 17 11 11 11 11 11 11 11 11 11 17 17 11 17 17 17 11 11 11 44 21 19 45 17 11 11 11 11 11 11 17 17 11 11 11 11 11 11 17 17 11 53 3 1 54 11 11 11 11 11 18 36 
36 16 11 11 11 11 11 11 17 17 11 17 17 11 11 11 11 11 11 11 11 17 17 11 11 44 45 11 11 11 11 53 3 1 54 17 11 11 11 11 11 11 17 17 28 29 30 11 17 17 11 11 11 17 53 54 11 11 11 11 11 11 18 36 
36 16 11 11 11 11 11 11 17 17 11 17 17 11 11 40 49 49 49 40 11 11 17 17 44 21 19 45 11 11 11 17 53 54 11 17 11 11 11 44 45 11 17 17 37 38 39 17 17 11 11 11 11 11 11 11 11 11 11 11 11 11 18 36 
36 16 11 11 11 11 11 17 17 11 11 17 17 11 40 40 33 33 33 40 40 49 40 17 53 3 1 54 11 11 17 17 11 11 17 17 11 11 44 21 19 45 17 11 46 47 48 11 17 17 11 11 11 11 11 28 29 30 11 11 11 11 18 36 
36 16 11 11 11 11 11 17 17 11 11 17 17 11 40 49 33 33 33 33 33 49 40 11 17 53 54 11 11 11 11 11 11 11 11 11 17 17 53 3 1 54 17 11 11 11 11 11 11 17 17 11 11 11 11 37 38 39 11 11 11 11 18 36 
36 16 11 11 28 29 30 17 17 11 11 11 11 11 40 40 33 33 33 33 33 33 40 40 17 17 11 11 11 11 11 11 11 11 17 17 11 11 17 53 54 11 17 11 11 44 45 11 11 11 17 28 29 30 11 46 47 48 11 11 11 11 18 36 
36 16 11 11 37 38 39 17 17 11 11 11 11 11 49 40 33 33 33 33 33 33 33 40 17 17 11 11 11 11 11 11 11 17 17 11 11 11 11 11 11 11 11 11 44 21 19 45 11 11 17 37 38 39 17 11 11 11 11 11 11 44 27 36 
36 16 11 11 46 47 48 11 11 11 11 44 45 11 40 40 33 33 33 33 33 33 33 40 17 17 11 11 11 11 11 11 11 11 17 17 11 11 11 11 11 11 11 11 53 3 1 54 11 11 17 46 47 48 17 11 11 11 11 11 11 18 36 36 
36 16 11 11 11 11 11 11 11 11 44 21 19 45 12 33 33 33 33 33 33 33 49 40 17 17 11 11 11 11 7 8 8 8 8 8 8 8 8 9 11 11 11 11 17 53 54 11 11 11 17 17 11 17 17 11 11 11 11 11 11 18 36 36 
36 16 11 11 11 11 11 11 11 11 53 3 1 44 21 33 33 33 33 33 33 40 40 40 44 45 11 11 11 11 16 7 8 8 8 8 8 8 9 18 11 11 11 11 11 11 17 17 11 11 17 17 11 17 17 11 11 11 11 11 11 18 36 36 
36 16 11 11 11 11 11 11 11 11 17 53 54 12 33 33 33 33 33 33 40 40 17 44 21 19 45 11 11 11 16 16 17 17 11 11 17 17 18 18 17 11 11 11 11 11 17 17 11 11 17 17 11 17 17 11 11 11 11 11 11 18 36 36 
36 16 11 11 11 11 11 11 11 11 11 11 11 53 3 33 33 33 1 40 40 11 11 53 3 1 54 17 17 11 16 16 17 7 8 8 9 17 18 18 17 11 11 11 11 11 11 11 11 11 17 17 11 11 11 11 11 11 11 11 11 18 36 36 
36 16 11 11 11 11 11 11 11 11 11 11 11 11 53 2 2 2 54 11 11 11 11 17 53 54 11 11 11 11 16 16 17 16 17 17 18 17 18 18 17 11 44 45 11 11 11 11 17 11 44 45 11 11 11 28 29 30 11 11 11 53 9 36 
36 16 11 11 11 44 45 11 11 11 11 11 11 11 11 11 11 11 11 44 45 11 11 11 11 11 11 11 17 17 16 16 17 16 17 17 18 17 18 18 17 44 21 19 45 11 11 17 17 44 21 19 45 11 11 37 38 39 11 11 11 11 18 36 
36 16 11 11 44 21 19 45 11 11 11 11 11 11 11 11 11 11 44 21 19 45 11 11 11 11 11 17 17 11 16 16 17 25 26 26 27 17 18 18 17 53 3 1 54 11 11 11 17 53 3 1 54 11 11 46 47 48 11 11 11 11 18 36 
36 16 11 11 53 3 1 54 11 11 11 11 11 11 17 17 11 11 53 3 1 54 11 11 11 11 11 11 17 17 16 16 17 17 11 11 17 11 18 18 17 17 53 54 11 11 42 23 23 43 53 54 11 11 11 11 11 11 11 11 11 11 18 36 
36 16 11 11 17 53 54 11 11 11 11 17 17 11 11 11 11 11 17 53 54 11 28 29 30 17 11 11 11 17 16 25 26 26 26 26 26 26 27 18 11 11 11 11 11 42 24 14 14 13 11 11 11 17 17 11 11 11 11 11 11 11 18 36 
36 16 11 11 11 11 11 11 11 17 17 11 11 11 11 11 11 11 11 11 11 11 37 38 39 11 11 11 11 11 25 26 26 26 26 26 26 26 26 27 11 17 11 11 42 24 14 14 14 22 23 23 23 43 11 11 11 11 11 11 11 44 27 36 
36 16 11 11 11 11 11 11 17 17 7 8 8 8 8 8 8 8 8 9 11 17 46 47 48 11 11 11 11 17 17 11 11 11 11 11 17 17 17 11 11 17 17 42 24 14 14 14 14 14 14 14 14 22 23 43 11 11 11 11 11 18 36 36 
36 16 11 11 11 11 11 11 11 17 16 7 8 8 8 8 8 8 9 18 11 11 17 17 11 11 11 11 11 17 11 11 11 11 11 11 11 17 17 11 11 11 17 15 14 14 14 14 14 14 14 14 14 14 14 13 11 11 11 11 11 18 36 36 
36 16 11 11 28 29 30 11 11 11 16 16 17 17 11 11 17 17 18 18 11 11 11 17 17 11 11 11 11 11 44 45 11 11 11 11 42 23 23 23 23 23 23 24 14 14 14 14 14 14 14 14 14 14 14 13 11 11 11 11 11 18 36 36 
36 16 11 11 37 38 39 17 11 11 16 16 17 7 8 8 9 17 18 18 17 11 28 29 30 17 11 17 11 44 21 19 45 11 42 23 24 14 14 14 14 14 14 14 14 14 14 14 14 14 14 14 14 14 14 13 44 45 11 11 11 18 36 36 
36 16 11 11 46 47 48 17 17 11 16 16 17 16 17 17 18 17 18 18 17 17 37 38 39 17 11 17 17 53 3 1 54 11 15 14 14 14 14 14 14 14 14 14 14 14 14 14 14 14 14 14 14 14 14 13 21 19 45 11 11 18 36 36 
36 16 11 11 11 11 11 17 17 11 16 16 17 16 17 17 18 17 18 18 17 17 46 47 48 17 11 17 17 17 53 54 11 11 15 14 14 14 14 14 14 14 14 14 14 14 14 14 14 14 14 14 14 4 5 52 3 1 54 11 11 18 36 36 
36 16 11 11 11 11 11 17 17 11 16 16 17 25 26 26 27 17 18 18 17 17 11 11 17 17 11 17 17 11 11 17 17 42 24 14 14 14 14 14 14 14 14 14 14 14 14 14 14 14 14 4 5 52 17 17 53 54 11 11 11 18 36 36 
36 16 11 11 11 11 11 17 17 11 16 16 17 17 11 11 17 11 18 18 17 17 11 11 17 17 11 17 17 11 11 17 17 15 14 14 14 14 14 14 14 14 14 14 14 14 14 14 14 14 4 52 11 17 17 11 17 17 11 11 11 18 36 36 
36 16 11 11 11 11 11 17 17 11 16 25 26 26 26 26 26 26 27 18 17 17 11 11 17 17 11 17 17 11 11 17 17 51 6 14 14 14 14 14 14 14 14 14 14 14 14 14 14 14 13 11 11 17 17 11 17 17 11 11 11 18 36 36 
36 16 11 11 11 44 45 11 17 11 25 26 26 26 26 26 26 26 26 27 17 17 11 11 17 11 44 45 11 11 11 17 17 11 15 14 14 14 14 14 14 14 14 14 14 14 14 14 4 5 52 11 11 17 11 11 17 17 11 11 11 18 36 36 
36 16 11 11 44 21 19 45 11 11 11 11 11 11 11 11 11 11 44 45 11 11 11 11 11 44 21 19 45 11 11 17 11 17 15 14 14 14 14 14 14 14 14 14 14 14 14 4 52 11 7 8 8 8 8 8 8 8 8 9 11 18 36 36 
36 16 11 11 53 3 1 54 11 11 11 17 17 11 11 11 17 44 21 19 45 11 11 11 17 53 3 1 54 11 11 11 17 17 15 14 14 14 14 14 14 14 14 14 4 5 5 52 11 11 16 7 8 8 8 8 8 8 9 18 11 18 36 36 
36 16 11 11 17 53 54 11 11 11 17 17 17 17 11 11 11 53 3 1 54 11 11 17 17 17 53 54 11 11 11 17 17 17 15 14 14 14 14 14 14 4 5 5 52 11 11 11 11 11 16 16 17 17 11 11 17 17 18 18 11 18 36 36 
36 16 11 11 11 11 11 11 11 17 17 11 17 17 11 11 17 17 53 54 11 11 17 17 11 17 17 11 11 11 17 17 17 17 51 5 6 14 14 14 4 52 11 17 17 11 11 11 11 11 16 16 17 7 8 8 9 17 18 18 11 53 9 36 
36 16 11 11 11 11 11 11 11 17 17 11 28 29 30 11 17 17 11 11 11 11 17 17 11 17 17 11 11 17 17 11 17 17 11 42 24 14 14 4 52 11 11 17 17 11 11 11 11 11 16 16 17 16 17 17 18 17 18 18 11 11 18 36 
36 16 11 11 11 11 11 11 11 17 17 11 37 38 39 11 11 17 11 11 11 11 17 17 11 17 17 11 11 17 17 11 17 17 11 15 14 14 4 52 11 11 44 45 11 11 11 11 11 11 16 16 17 16 17 17 18 17 18 18 11 11 18 36 
36 16 11 11 11 11 11 11 17 17 11 11 46 47 48 11 11 17 11 11 11 28 29 30 11 17 17 11 11 28 29 30 17 17 11 51 5 5 52 17 17 44 21 19 45 11 11 11 11 11 16 16 17 25 26 26 27 17 18 18 11 44 27 36 
36 25 45 11 11 11 11 11 17 17 11 11 17 17 11 11 11 17 11 11 11 37 38 39 11 17 17 11 11 37 38 39 17 17 11 11 11 11 11 11 11 53 3 1 54 11 11 11 11 11 16 16 17 17 11 11 17 11 18 18 11 18 36 36 
36 36 25 45 11 11 11 11 17 17 11 11 11 11 11 11 11 17 11 11 11 46 47 48 11 11 11 11 11 46 47 48 17 17 11 11 11 11 11 11 11 17 53 54 11 11 11 11 11 11 16 25 26 26 26 26 26 26 27 18 44 27 36 36 
36 36 36 25 26 45 11 11 11 11 11 11 11 11 11 11 11 17 17 11 11 11 11 11 11 11 11 11 17 17 11 11 11 11 11 11 11 11 11 11 11 11 11 11 11 11 11 11 17 17 25 26 26 26 26 26 26 26 26 27 27 36 36 36 
36 36 36 36 36 25 45 11 11 11 11 11 11 11 11 11 11 17 17 11 11 11 11 11 11 11 11 11 11 11 11 11 11 11 11 11 11 11 11 11 11 11 11 11 11 11 11 11 17 11 11 11 11 11 11 11 11 11 44 27 36 36 36 36 
36 36 36 36 36 36 25 26 26 26 26 45 11 11 11 11 11 17 11 11 11 11 11 11 11 11 11 11 11 11 11 11 11 44 26 26 26 26 26 45 11 11 11 11 11 11 11 11 11 11 11 11 11 11 11 11 11 44 27 36 36 36 36 36 
36 36 36 36 36 36 36 36 36 36 36 25 26 26 26 26 26 26 26 26 26 26 26 26 26 26 26 26 26 26 26 26 26 27 36 36 36 36 36 25 26 26 26 26 26 26 26 26 26 26 26 26 26 26 26 26 26 27 36 36 36 36 36 36 
36 36 36 36 36 36 36 36 36 36 36 36 36 36 36 36 36 36 36 36 36 36 36 36 36 36 36 36 36 36 36 36 36 36 36 36 36 36 36 36 36 36 36 36 36 36 36 36 36 36 36 36 36 36 36 36 36 36 36 36 36 36 36 36
