36 14 36 36 36 36 14 36 36 36 14 14 14 36 14 14 14 36 36 36 36 36 14 36 14 14 14 14 14 14 14 14 14 14 14 14 14 14 14 14 14 14 14 14 14 14 14 14 14 14 14 14 14 14 14 14 14 14 14 14 14 14 14 14 
36 36 36 14 14 31 31 31 31 31 31 31 14 36 14 14 14 14 14 14 14 14 14 14 36 36 36 14 14 36 36 14 14 14 36 14 14 14 14 14 14 14 14 14 14 14 14 14 14 14 14 14 14 14 14 14 14 14 14 14 14 14 14 14 
14 14 14 14 31 31 31 31 31 31 31 31 14 36 36 14 14 14 4 5 5 5 5 6 14 14 14 14 14 14 14 36 14 14 36 36 14 36 36 14 14 14 14 14 14 14 14 14 14 14 14 14 14 14 14 14 14 14 14 14 14 14 14 14 
36 14 14 31 31 31 31 31 31 31 31 31 14 14 36 14 14 4 52 11 11 11 11 51 5 5 5 6 14 14 14 14 14 14 14 36 14 14 36 36 36 36 14 14 14 36 36 36 36 14 14 14 14 14 14 14 14 14 14 14 14 14 14 14 
36 36 14 31 31 31 31 31 31 31 31 31 14 14 36 14 14 13 11 11 28 29 30 11 11 11 11 51 5 5 5 5 6 14 14 14 14 14 14 14 14 36 36 14 14 36 14 14 14 14 36 36 14 36 36 36 36 14 14 14 14 14 14 14 
36 36 31 31 31 14 31 31 31 31 31 31 14 14 14 14 14 45 11 11 37 38 39 11 11 11 11 11 11 11 40 40 51 5 6 14 14 14 36 14 14 14 36 14 14 14 14 14 14 14 36 14 14 14 14 14 14 14 14 14 14 14 14 14 
36 31 31 31 14 14 14 14 31 31 31 14 14 14 14 14 33 19 20 45 46 47 48 11 11 11 40 11 11 11 11 40 11 11 15 14 14 14 36 36 14 14 14 14 14 33 33 33 33 14 14 14 14 14 36 36 36 36 36 36 36 36 14 14 
36 31 31 14 14 14 14 31 31 31 31 14 14 14 14 33 33 33 33 19 20 20 20 20 20 45 40 40 40 40 11 40 11 11 15 14 14 14 14 36 14 14 14 14 33 33 14 14 33 33 14 14 14 14 14 14 14 14 14 36 14 14 14 14 
36 31 31 31 14 14 31 31 31 31 14 14 14 14 33 33 33 33 33 33 33 33 33 33 33 19 20 45 11 40 40 40 11 11 51 6 14 14 14 36 14 14 14 33 33 14 14 14 33 33 14 14 14 14 14 14 36 36 36 36 14 14 14 14 
36 31 31 31 31 31 31 31 31 31 14 14 14 33 33 33 33 33 33 33 33 33 33 33 33 33 33 19 20 20 45 40 11 11 42 24 14 14 14 14 14 14 33 33 14 14 4 5 17 17 6 14 14 14 14 14 14 14 14 14 36 36 14 14 
36 31 31 31 31 31 31 31 31 14 14 14 31 33 50 50 50 33 33 33 33 33 33 33 33 33 33 33 33 33 19 20 20 11 15 14 14 14 14 14 14 14 33 14 14 14 13 17 17 17 51 5 5 6 14 14 14 14 36 36 14 14 14 14 
36 31 31 31 31 31 31 31 31 31 31 31 31 31 31 50 50 50 50 50 50 33 50 50 50 50 50 33 33 33 33 33 33 11 15 14 14 36 14 14 14 14 33 14 14 4 52 17 28 29 30 17 17 51 5 5 6 14 14 14 14 14 14 14 
36 31 31 31 31 31 31 31 31 31 31 31 31 31 31 31 31 31 31 33 50 50 50 50 50 50 50 50 33 33 33 33 33 33 33 14 14 36 14 14 14 14 33 14 4 52 17 17 37 38 39 17 17 17 17 17 15 14 14 36 36 36 36 14 
36 31 31 31 31 31 31 14 31 31 31 31 31 31 31 31 31 31 31 31 31 31 31 31 31 31 33 33 33 33 33 33 33 14 33 14 14 36 14 14 14 33 33 14 13 17 17 17 46 47 48 17 28 29 30 17 15 14 14 14 14 14 36 36 
36 14 31 31 31 14 14 14 14 14 14 31 31 50 31 31 31 31 31 31 31 31 31 31 31 31 31 31 31 31 14 14 14 14 33 33 14 14 14 14 33 33 14 14 13 40 40 17 17 17 17 17 37 38 39 17 51 6 14 36 36 14 14 14 
36 31 31 31 14 14 14 14 14 14 14 31 31 31 31 50 31 31 31 31 31 31 31 31 31 14 14 14 14 14 14 36 36 14 14 33 33 33 33 33 33 14 14 14 13 17 40 17 17 17 17 17 46 47 48 17 17 15 14 14 14 36 36 14 
36 31 14 14 14 14 14 14 14 14 14 14 14 14 31 31 31 31 31 31 31 14 14 14 14 14 14 14 14 14 14 14 14 36 36 14 14 14 14 14 14 14 14 14 13 17 40 40 17 49 49 17 17 17 17 17 42 24 14 36 14 14 36 14 
36 31 36 14 14 36 36 14 14 14 14 14 14 14 14 14 14 14 14 14 14 14 14 14 14 14 14 14 14 14 14 36 36 14 14 14 14 14 14 14 14 14 14 14 13 17 17 40 17 17 17 49 17 17 49 17 15 14 14 14 36 36 14 14 
36 31 36 14 14 14 36 36 36 36 14 14 14 14 14 14 14 14 14 14 36 14 14 14 36 36 14 14 14 14 14 14 36 14 14 14 36 14 14 14 14 14 14 14 22 43 17 40 17 17 17 17 17 49 49 17 15 14 14 14 14 36 36 14 
36 31 14 14 14 14 14 14 14 14 36 36 14 14 14 36 36 14 14 14 36 14 14 14 14 14 36 36 36 36 14 14 14 14 14 14 36 36 14 14 14 14 14 14 14 22 43 42 23 23 23 23 23 43 17 17 51 14 14 36 36 14 14 36 
36 31 36 14 14 14 14 14 14 14 14 14 14 14 14 14 14 36 36 14 36 36 14 14 14 14 14 14 14 14 36 36 36 36 36 14 14 36 36 14 14 14 14 14 14 14 22 24 14 14 14 14 14 22 23 23 43 14 14 14 36 36 36 14 
36 31 14 14 14 14 14 14 14 14 14 14 14 14 14 14 14 14 14 14 14 14 36 36 36 36 36 14 14 14 14 14 14 14 36 14 14 14 14 36 14 14 14 14 14 14 14 14 14 14 14 14 14 14 14 14 52 14 14 14 14 14 14 36 
36 31 36 14 14 14 14 14 14 14 14 14 14 36 36 36 36 14 14 14 14 14 14 14 14 14 14 14 14 14 14 14 14 14 14 14 14 14 14 14 14 14 14 14 14 14 14 14 14 14 31 31 14 14 14 14 31 31 31 14 36 36 14 14 
14 31 36 14 14 14 31 31 31 31 31 14 14 14 14 14 36 14 14 14 14 14 14 14 14 14 14 14 14 33 33 33 33 33 33 33 33 14 14 14 14 14 14 14 14 14 31 31 31 14 31 31 14 14 14 31 31 31 31 31 14 36 36 14 
14 31 36 14 14 14 31 31 31 31 31 31 14 14 14 14 14 14 14 14 14 33 33 33 33 33 33 33 33 1 2 2 2 2 2 2 3 50 33 33 14 14 14 14 14 14 31 31 31 14 31 31 31 14 31 31 31 31 31 31 31 14 36 36 
14 31 36 14 14 14 31 31 31 31 31 31 14 14 14 14 33 33 33 33 33 1 2 2 2 2 2 2 2 54 11 11 11 17 11 11 12 50 50 33 33 14 14 14 14 31 31 31 31 14 14 14 31 31 31 31 31 31 31 31 31 31 36 14 
14 31 36 14 14 14 31 31 31 31 31 31 14 14 14 33 33 1 2 2 3 10 11 11 11 11 11 17 49 49 49 11 17 17 11 11 12 1 2 3 33 31 31 14 14 31 31 31 31 14 14 14 14 31 31 31 31 31 31 31 31 31 14 36 
14 31 36 14 14 14 31 31 31 31 31 31 14 14 14 33 1 54 11 11 12 19 45 11 17 49 49 49 49 11 49 11 11 11 11 11 12 10 11 53 2 3 31 14 14 31 31 31 31 31 14 14 14 31 31 31 31 31 31 31 31 31 14 36 
14 31 36 14 14 14 31 31 31 31 31 31 14 14 14 33 10 44 11 11 53 3 10 11 49 11 11 17 17 17 49 11 11 11 11 44 21 10 28 29 30 12 33 14 14 14 31 31 31 31 31 14 14 14 14 31 31 31 31 31 31 14 14 14 
14 31 14 36 14 14 31 31 31 31 31 31 14 14 14 33 19 21 17 11 11 53 54 49 11 11 11 11 11 11 11 28 29 30 44 21 1 54 37 38 39 12 33 14 14 14 31 31 31 31 31 14 14 14 14 31 31 31 31 31 14 14 14 14 
14 31 36 14 14 31 31 31 31 31 31 31 14 14 14 14 1 54 17 11 11 11 11 11 17 11 11 11 11 17 11 37 38 39 21 1 54 11 46 47 48 12 33 33 14 14 31 31 31 31 31 31 14 14 14 31 31 31 31 31 14 36 14 14 
14 31 36 14 14 31 31 31 31 31 31 31 14 14 14 14 54 11 17 11 11 17 11 11 17 17 11 11 11 17 11 46 47 48 1 54 11 11 11 44 20 21 33 33 14 14 31 31 31 31 31 31 31 31 31 31 31 31 31 31 14 14 36 14 
14 31 36 14 14 31 31 31 31 31 31 31 31 11 11 11 11 17 17 11 11 17 11 11 11 17 40 17 11 17 17 11 11 53 54 11 11 11 44 21 33 33 14 14 14 36 36 31 31 31 31 31 31 31 31 31 31 31 31 14 14 14 36 36 
14 31 36 14 14 31 31 31 31 31 31 31 31 31 11 11 11 11 11 11 11 40 11 11 11 40 11 11 40 40 17 11 11 11 11 44 20 20 21 33 33 14 14 14 14 14 14 31 31 31 31 31 31 31 31 31 31 31 14 36 36 14 14 36 
14 31 36 36 14 31 31 31 31 31 31 31 31 31 31 11 14 17 11 11 11 11 11 40 40 11 11 40 11 40 11 11 11 11 44 21 33 31 31 33 14 14 14 36 14 14 36 36 36 14 31 31 31 31 31 36 14 14 14 14 36 36 36 14 
14 31 36 14 14 31 31 31 31 31 31 31 31 14 14 14 14 17 11 11 40 11 17 11 40 11 11 40 11 31 31 31 31 31 31 31 14 14 14 14 14 36 14 36 36 36 14 14 14 36 36 14 14 31 14 14 36 36 14 14 14 14 14 14 
14 31 36 36 14 31 31 31 31 31 31 14 14 14 14 14 31 31 17 40 11 11 40 40 11 11 31 31 31 31 31 36 36 36 31 14 14 14 31 31 14 36 36 36 14 36 14 14 14 14 14 14 14 31 14 14 14 14 14 36 36 14 14 14 
14 31 14 36 14 31 31 31 31 31 31 14 14 14 14 14 31 31 17 11 40 11 11 11 31 31 14 36 36 36 36 36 14 14 31 14 14 14 31 31 31 14 14 14 36 14 14 14 14 14 50 50 50 33 50 50 50 50 14 14 36 36 14 14 
14 31 14 36 14 31 31 14 14 14 14 14 14 14 14 14 31 49 17 11 49 31 14 14 31 31 36 14 14 14 14 14 14 14 31 31 31 31 31 31 31 14 14 14 36 36 14 14 14 50 50 50 50 33 50 50 50 50 50 14 14 36 36 14 
14 31 14 36 36 14 14 14 14 14 14 14 31 31 31 31 31 31 49 49 11 11 14 14 31 31 36 36 14 14 14 14 14 14 14 14 14 31 14 31 31 31 14 14 14 36 14 50 50 50 50 50 50 33 33 33 33 50 50 14 14 14 14 14 
14 31 36 14 36 14 14 14 14 14 14 31 31 31 31 31 31 31 31 11 11 31 14 14 31 31 14 14 14 14 14 14 14 14 14 14 14 14 14 14 31 31 31 31 50 50 50 33 50 50 50 50 33 50 50 50 33 50 50 50 14 14 14 14 
14 31 36 14 14 14 14 14 14 14 31 31 31 31 31 31 31 31 31 31 31 31 14 14 31 31 31 36 36 14 14 14 36 36 36 14 14 14 14 14 14 31 31 31 33 33 50 33 33 33 33 33 33 50 50 50 33 50 50 50 14 14 14 14 
14 31 36 14 14 14 14 14 31 31 31 31 31 31 31 31 31 31 14 14 14 14 14 14 14 31 31 14 36 36 14 14 14 14 36 36 36 14 14 14 14 14 14 14 50 33 50 50 50 33 50 50 33 50 50 50 33 33 33 33 50 14 14 14 
14 31 36 36 14 14 14 14 31 31 31 31 31 31 31 14 14 14 14 36 36 14 14 14 14 31 31 14 14 36 36 36 14 14 14 36 36 36 36 36 14 14 14 50 50 33 33 33 50 33 50 50 33 50 50 50 50 50 50 33 50 14 14 14 
14 31 36 36 14 14 14 14 14 31 31 31 14 14 14 14 14 14 14 14 36 36 14 31 31 31 31 31 31 31 31 14 14 14 14 36 36 14 14 36 36 14 14 50 50 50 50 34 50 33 50 50 33 33 33 33 33 33 33 33 50 14 14 14 
14 31 14 36 36 14 14 14 14 14 14 14 14 14 14 14 36 36 36 14 14 14 31 31 7 8 8 8 8 9 31 31 31 14 14 14 36 36 14 14 14 14 14 14 50 34 34 34 34 34 50 50 50 50 33 50 33 50 50 50 50 14 14 14 
14 31 14 14 36 14 14 14 14 14 14 14 36 14 14 14 14 14 14 14 31 31 31 7 28 29 30 11 49 18 31 31 31 31 31 14 14 36 36 14 14 14 14 14 50 33 50 50 50 50 50 50 50 50 50 50 33 50 50 50 14 14 14 14 
14 31 36 14 36 14 14 14 36 36 14 14 36 36 14 14 14 14 14 31 11 11 11 16 37 38 39 49 49 49 8 9 31 31 31 31 14 14 36 14 14 14 14 14 50 33 33 33 33 33 50 33 33 33 33 33 33 50 50 14 14 14 14 14 
14 31 36 14 36 36 36 14 14 36 36 36 14 14 36 14 14 14 14 31 11 11 7 54 46 47 48 17 17 17 17 53 9 31 31 31 31 36 36 36 36 14 14 14 50 50 50 50 50 33 33 33 50 50 50 50 50 50 14 14 14 14 14 14 
14 31 36 14 31 14 36 14 14 14 14 14 36 14 36 36 14 14 14 31 11 11 16 28 29 30 11 7 8 8 8 9 53 9 31 31 31 36 36 36 36 36 36 36 14 14 14 14 14 50 50 50 50 50 50 50 14 14 14 14 14 14 14 31 
14 31 14 31 31 31 31 31 31 31 14 14 14 14 14 14 14 14 31 31 11 11 16 37 38 39 11 16 7 8 9 53 9 18 31 31 31 14 14 14 14 14 14 36 36 14 14 14 14 14 14 14 14 14 14 14 14 14 14 14 14 14 14 31 
14 31 14 31 31 31 31 31 31 31 31 31 14 14 14 14 14 14 31 31 11 11 16 46 47 48 11 16 16 40 18 40 18 18 31 31 31 14 14 14 14 14 14 14 36 14 14 14 14 14 14 14 14 14 14 14 14 14 14 14 14 14 31 11 
14 31 14 31 31 31 31 31 31 31 31 31 31 14 14 36 14 14 14 31 31 11 16 40 40 11 11 16 25 26 27 40 18 18 31 31 31 36 36 36 36 14 14 14 14 14 14 14 14 14 14 14 14 14 14 14 14 14 14 14 14 31 11 11 
14 31 14 31 31 31 31 31 31 31 31 31 31 31 14 14 36 14 14 31 33 11 25 26 26 26 45 25 26 26 26 26 27 18 31 31 14 36 36 36 36 14 14 14 14 14 14 14 14 14 14 14 14 14 14 14 14 14 14 14 31 11 11 11 
14 31 14 31 31 31 31 31 31 31 31 31 31 31 14 14 36 36 14 31 33 33 33 11 11 11 25 26 45 40 44 26 45 18 31 31 14 14 14 14 36 36 36 14 14 14 14 14 14 14 14 14 14 31 31 31 31 31 31 31 11 11 11 11 
14 31 31 31 31 31 31 31 31 31 31 31 31 31 14 14 36 14 14 31 31 33 33 33 33 11 11 11 16 40 18 11 25 27 31 14 36 14 14 14 14 14 14 14 14 14 14 14 31 31 31 31 31 31 31 31 31 31 11 11 11 40 11 11 
14 31 31 31 31 31 31 31 31 31 31 31 31 14 14 14 36 36 36 14 31 31 50 50 50 33 33 40 25 26 27 40 11 31 31 14 36 36 14 14 14 14 14 14 14 14 31 31 11 11 11 11 11 11 11 11 11 11 11 11 40 40 11 40 
14 31 31 31 31 31 31 31 31 31 31 31 31 14 14 14 14 14 36 36 31 31 31 31 50 50 33 33 33 31 31 33 33 31 14 14 14 36 36 14 14 14 31 31 31 31 31 11 11 40 40 40 40 40 40 40 11 40 40 11 11 11 40 11 
14 31 31 31 31 31 31 31 31 31 31 31 31 14 36 14 14 14 14 14 31 31 31 31 31 31 50 33 33 33 33 33 31 31 14 14 14 14 36 14 14 14 31 31 31 31 31 11 40 11 40 40 40 40 40 11 11 11 40 40 40 11 40 11 
14 31 31 31 31 31 31 31 31 31 31 31 31 14 36 36 14 14 14 14 31 31 31 31 31 31 31 31 31 33 33 33 31 14 14 14 14 14 14 14 14 14 14 31 31 31 31 11 40 11 11 40 40 40 40 40 40 40 40 40 40 40 40 11 
14 31 31 31 31 31 31 31 31 31 31 31 31 14 14 36 36 36 14 14 14 31 31 31 31 14 31 31 31 31 31 31 31 36 36 14 14 14 14 14 14 14 14 14 31 31 31 31 11 40 40 11 40 11 40 11 11 40 11 11 40 40 40 11 
14 14 31 31 31 31 31 31 31 31 31 31 14 14 14 14 14 36 36 36 14 14 14 14 14 36 36 14 14 14 14 14 14 14 14 36 36 36 36 36 14 14 14 14 14 14 14 14 31 11 11 11 40 40 11 40 11 11 11 40 40 11 40 40 
14 14 36 14 14 14 14 31 31 31 14 14 14 36 36 14 14 14 14 14 14 14 14 14 14 14 14 36 36 36 14 14 14 14 14 36 36 14 14 36 36 14 36 36 36 14 14 36 14 14 14 11 11 11 11 11 11 11 40 11 11 40 40 40 
14 14 14 36 36 36 36 36 14 36 36 36 36 36 36 36 36 14 14 14 14 14 14 14 14 14 14 14 14 14 36 36 36 36 14 14 36 36 36 14 14 14 14 14 36 36 14 14 36 36 36 36 36 36 14 14 14 14 11 11 11 11 11 11
