22222222222222222222222222222222
22222222222222222222222222222222
11111111111111111111115555555555
11111111111111111111155555555555
11111111111111111111555555555555
11111111111111111155555555555555
11111111111111115555555555515555
11111111111111555555555555115555
11111111444444446464445555111555
41111111444464644464445555111555
41111111443333333333445555555555
44111111443333333333445555555555
44111111443333333333445555555556
44111111463333333333445551155564
44111111443333333333445511155544
44111111443333333333645511155646
44111111443333333333445511156446
44111111643333333333645555556466
44111111443333333333445555566666
64111111463333333333465555566664
64111111444446446444445555666666
64411111444644444444445555654466
64411111555555555555555556664446
64441111555555555555555556644666
66441111555155555555555566664666
66644115555155555555555664656666
64664555551115555555555666666664
66664555511115555555556646666644
64665555511115555555566666446664
64665555555555555556666444466444
64666666666666466666444466666666
64666644466666666666666666666665