14 14 14 14 14 14 14 14 14 14 14 36 36 36 36 14 14 14 14 14 14 14 14 14 14 14 14 14 14 14 14 14 14 14 14 14 14 14 14 14 14 14 14 14 14 14 14 14 14 14 14 14 14 14 14 14 36 14 14 14 14 14 14 14 
14 14 14 14 36 36 36 36 36 36 36 36 14 14 14 14 14 14 14 14 14 14 14 31 31 31 31 31 31 31 31 31 31 31 31 31 14 14 14 14 14 14 14 14 14 14 14 14 14 14 14 36 36 36 36 36 36 14 14 14 14 14 14 14 
14 14 14 36 36 14 36 36 36 14 14 14 14 14 14 14 14 14 14 14 14 31 31 31 33 33 33 33 33 33 33 33 33 33 31 31 31 31 31 14 14 14 14 14 14 14 14 14 14 14 36 36 14 14 14 14 14 14 14 14 14 14 36 14 
14 14 14 14 36 36 36 14 14 14 14 36 36 14 14 14 14 14 14 14 31 31 33 33 33 1 2 2 2 2 2 3 50 33 33 33 33 33 31 31 31 31 31 31 31 31 14 14 14 14 14 14 14 14 14 14 14 14 14 14 14 36 36 14 
14 14 36 36 36 14 14 36 36 36 36 36 14 14 14 14 14 31 31 31 33 33 33 1 2 54 17 17 17 17 17 53 2 2 2 2 3 50 33 33 33 33 31 31 31 31 31 31 31 14 14 14 14 14 14 14 14 36 36 36 36 36 14 14 
14 14 36 14 14 14 14 36 14 14 14 14 14 14 14 31 31 31 33 33 50 1 2 54 17 17 17 11 11 11 11 11 17 17 17 17 53 2 2 2 3 50 33 33 33 33 33 33 31 31 14 14 14 14 14 14 36 36 14 14 14 14 14 14 
14 14 14 14 14 36 14 14 14 14 14 14 14 31 31 31 33 33 33 1 2 54 17 17 17 11 11 11 17 17 17 11 11 11 11 11 11 17 17 17 53 2 2 2 2 2 3 33 33 31 31 14 14 14 14 14 14 14 14 14 14 14 14 14 
14 14 14 14 36 36 14 14 14 14 14 31 31 33 33 33 33 1 2 54 17 17 28 29 30 11 11 11 11 11 11 11 17 17 11 11 11 11 17 17 17 17 17 17 17 17 53 2 3 33 31 31 14 14 14 14 14 14 14 14 14 14 14 14 
14 14 14 36 36 14 14 14 14 14 31 31 33 33 1 2 2 17 17 17 11 11 37 38 39 11 11 17 17 17 17 17 17 17 17 17 11 11 17 17 17 17 17 17 17 17 17 17 12 33 31 31 31 14 14 14 14 14 14 14 14 14 36 36 
14 36 36 36 14 14 14 14 14 31 31 33 33 1 54 17 17 17 11 11 11 17 46 47 48 17 17 17 17 17 17 17 17 17 17 17 11 11 17 17 17 17 17 17 17 17 17 17 53 3 33 33 31 14 14 14 14 14 14 14 14 36 36 14 
14 36 14 14 14 14 14 14 31 31 33 50 1 54 17 17 17 11 11 17 11 11 11 17 17 17 17 17 17 17 28 29 30 17 17 17 11 11 17 17 11 11 11 11 11 17 17 17 17 53 3 33 31 31 14 14 14 14 14 14 14 36 14 14 
14 14 14 14 14 14 14 31 31 33 33 1 54 17 17 17 28 29 30 11 11 17 17 17 17 17 17 17 17 17 37 38 39 17 17 17 11 11 17 11 11 17 17 17 11 17 17 17 17 17 12 50 33 31 14 14 14 14 14 14 36 36 14 14 
14 14 14 36 14 14 31 31 33 50 1 54 11 11 17 11 37 38 39 17 17 17 17 11 11 11 17 17 40 40 46 47 48 17 17 17 11 7 8 8 8 8 8 8 8 8 9 17 17 17 53 3 33 31 14 14 14 14 14 14 36 14 14 14 
14 14 14 36 14 14 31 33 33 1 54 11 11 11 11 11 46 47 48 17 11 11 11 11 11 11 17 40 40 17 17 17 17 17 17 17 11 16 28 29 30 17 17 17 49 17 18 17 17 17 17 12 50 33 31 14 14 14 14 14 36 14 14 14 
14 14 36 36 14 14 31 33 1 54 11 17 17 11 11 11 17 17 17 17 17 49 49 17 11 11 17 40 17 17 17 17 17 17 17 11 11 16 37 38 39 40 11 11 11 17 18 17 17 17 17 53 3 33 31 14 14 14 14 14 14 14 14 14 
14 14 36 14 14 31 31 33 10 11 11 17 17 17 17 11 17 17 17 17 17 49 17 17 11 17 17 40 17 17 17 17 17 17 11 11 11 16 46 47 48 40 11 11 17 17 18 17 17 17 17 17 12 33 31 31 14 14 14 14 14 14 14 14 
14 14 36 14 14 31 31 33 10 11 17 17 49 17 7 8 8 8 8 8 8 8 8 9 11 11 40 40 17 17 17 17 17 11 11 11 11 16 17 11 40 40 11 11 17 17 18 17 17 17 17 17 12 33 33 31 14 14 14 14 14 14 14 14 
14 36 14 14 14 31 33 33 10 11 17 17 49 17 16 28 29 30 17 17 17 40 17 18 11 11 11 17 17 17 17 17 11 11 17 17 17 16 17 40 40 17 17 11 49 11 18 11 11 11 11 17 53 3 33 31 14 14 14 14 14 14 36 14 
14 36 14 14 14 31 33 50 10 11 17 17 49 17 16 37 38 39 49 11 40 40 17 18 11 11 11 11 17 17 11 11 11 17 17 17 17 16 17 17 17 17 11 11 11 11 18 17 11 11 11 11 17 12 50 31 31 14 14 14 14 36 36 14 
14 36 14 36 31 33 33 1 54 11 17 17 49 17 16 46 47 48 11 40 40 17 49 18 17 11 11 17 17 11 11 17 17 17 17 49 17 25 26 26 26 26 26 26 26 26 27 17 17 11 17 11 11 53 3 33 31 14 14 14 14 36 14 14 
14 36 14 36 31 33 1 54 17 11 17 17 49 49 16 17 11 17 40 40 28 29 30 18 49 17 17 17 11 11 17 49 49 49 49 49 17 17 17 17 11 11 11 11 17 17 17 17 17 11 17 17 11 17 12 33 31 31 14 14 36 36 14 14 
14 14 14 36 31 33 10 17 17 11 17 17 17 49 16 49 17 40 40 17 37 38 39 18 49 49 17 17 11 17 49 49 17 17 17 17 17 17 17 11 11 11 11 17 17 17 17 17 17 11 28 29 30 11 12 33 31 31 31 14 14 14 14 14 
14 14 14 36 31 33 10 17 17 11 17 17 17 49 16 17 40 40 17 11 46 47 48 18 17 49 49 17 11 11 49 17 17 17 17 17 17 11 11 11 11 11 17 17 17 17 40 40 17 11 37 38 39 11 53 3 33 31 31 14 14 14 14 14 
14 14 14 36 31 33 10 17 17 11 17 17 17 17 25 26 26 26 26 26 26 26 26 27 17 17 49 49 17 11 49 17 17 17 11 11 11 11 17 17 11 17 17 17 17 40 40 17 17 11 46 47 48 11 11 12 33 33 31 31 14 14 14 14 
14 14 14 14 31 33 10 17 17 11 11 17 17 17 17 11 11 11 17 17 17 17 11 17 17 17 17 49 17 11 17 17 11 11 11 17 17 17 17 17 11 11 11 17 17 40 17 17 17 11 11 17 17 11 17 53 3 33 31 31 14 14 14 36 
14 14 14 14 31 33 10 17 17 17 11 11 17 17 17 17 17 17 17 40 40 17 11 17 17 17 17 17 17 11 17 11 11 17 17 17 40 17 17 17 17 17 11 17 17 40 17 17 17 17 11 17 17 11 17 17 12 50 31 31 14 14 36 36 
14 14 14 31 33 33 10 17 17 17 11 11 17 17 17 17 17 17 40 40 17 11 11 17 17 17 17 17 17 11 11 11 17 17 17 40 40 17 17 17 17 17 11 11 17 40 40 17 17 17 11 11 11 11 17 17 53 3 33 31 14 36 36 14 
14 14 14 31 33 1 54 17 28 29 30 17 17 17 17 17 40 40 40 17 17 11 17 28 29 30 17 17 11 11 11 17 17 17 40 40 17 17 17 17 28 29 30 11 17 17 40 40 17 17 17 17 11 11 17 17 17 12 33 31 14 36 14 14 
14 14 14 31 33 10 17 17 37 38 39 17 17 49 17 17 40 17 17 17 11 11 17 37 38 39 17 17 11 11 17 17 17 40 40 17 17 17 17 17 37 38 39 11 11 17 17 40 40 17 17 17 17 11 11 17 17 12 33 31 31 14 14 14 
14 14 14 31 33 10 17 17 46 47 48 17 17 17 17 17 40 17 17 17 11 17 17 46 47 48 17 11 11 17 17 17 40 40 17 17 17 17 17 17 46 47 48 17 11 17 17 17 17 40 17 17 17 17 11 11 17 12 50 33 31 14 14 36 
14 14 36 31 33 10 17 17 11 42 23 23 23 23 43 17 17 17 17 17 11 17 17 17 17 17 11 11 17 17 17 40 40 17 17 17 17 28 29 30 17 17 17 17 11 17 17 17 17 40 17 17 17 17 17 11 11 53 3 33 31 14 36 36 
14 14 36 31 33 10 17 17 11 15 14 14 14 14 13 17 17 17 17 11 11 11 11 11 11 11 11 11 17 17 40 40 17 17 17 17 17 37 38 39 17 17 17 17 11 17 17 17 17 40 17 17 17 17 17 11 11 17 12 33 31 36 36 14 
14 36 36 31 33 10 17 49 11 15 14 14 14 14 13 17 17 17 11 11 17 11 11 11 11 11 17 17 17 17 40 17 17 17 17 17 17 46 47 48 17 17 17 17 11 11 17 17 17 40 17 17 17 17 17 11 11 17 12 33 31 36 14 14 
14 36 14 31 33 10 17 17 11 15 14 14 14 14 13 17 17 17 11 11 11 11 17 17 17 17 17 17 17 40 40 17 17 17 17 17 17 17 17 17 17 17 17 17 17 11 17 17 17 40 17 17 17 17 17 17 11 17 12 33 31 14 14 14 
14 36 14 31 33 10 17 40 11 51 5 5 5 5 52 17 17 11 11 11 11 17 17 17 17 17 17 17 40 40 17 17 17 17 17 17 17 17 17 11 11 11 17 17 17 11 17 17 17 40 17 17 17 17 17 17 11 17 12 33 31 14 14 14 
14 36 14 31 33 10 17 40 40 17 17 17 17 17 17 17 11 11 11 17 11 17 17 49 17 17 17 17 40 17 17 17 17 17 17 17 11 11 11 11 11 11 17 11 11 11 17 17 17 17 17 17 17 17 17 17 11 17 12 33 31 14 14 36 
14 14 14 31 33 19 45 17 40 40 11 17 17 17 17 11 11 17 17 17 11 17 17 49 17 17 17 17 17 17 17 17 17 17 17 11 11 17 17 17 17 17 11 11 7 8 8 8 8 8 8 8 8 9 17 17 11 44 21 33 31 14 14 36 
14 14 14 31 33 50 10 17 11 11 11 17 17 17 11 11 17 28 29 30 11 17 17 49 49 17 17 17 17 17 28 29 30 17 11 11 11 17 17 17 17 17 11 17 16 11 40 40 40 17 28 29 30 18 17 17 11 12 50 33 31 14 36 36 
14 14 14 31 31 33 10 17 17 11 11 17 17 11 11 17 17 37 38 39 11 11 17 17 49 17 17 17 17 17 37 38 39 11 11 11 11 17 17 17 17 17 11 11 16 40 40 17 17 17 37 38 39 18 17 11 11 12 33 31 14 14 36 14 
14 14 14 31 31 33 10 17 17 11 11 11 11 11 17 17 17 46 47 48 17 11 17 17 49 49 17 17 17 17 46 47 48 11 17 11 17 17 17 17 17 17 17 11 16 40 17 11 17 17 46 47 48 18 17 11 17 12 33 31 14 14 36 14 
14 14 14 31 31 33 10 17 17 11 11 11 11 17 17 17 17 17 17 17 17 11 17 17 17 17 49 49 17 17 17 17 11 11 17 11 17 28 29 30 17 17 17 17 16 40 40 40 11 17 17 11 11 18 17 11 17 12 33 31 14 14 14 14 
14 14 14 14 31 33 10 17 17 17 11 28 29 30 11 11 11 11 11 17 17 11 17 17 17 17 17 49 49 17 17 17 11 17 17 11 17 37 38 39 17 17 17 17 16 11 11 40 40 40 17 17 17 18 17 11 17 12 33 31 14 14 14 14 
14 14 14 14 31 33 19 45 17 17 11 37 38 39 17 17 17 17 11 11 11 11 17 17 17 17 17 17 17 17 17 17 11 17 11 11 17 46 47 48 17 11 11 11 16 17 11 11 17 17 17 17 11 18 11 11 44 21 33 31 14 14 14 36 
14 36 14 14 31 33 33 10 17 17 11 46 47 48 17 17 17 11 11 11 17 17 17 17 17 17 17 17 17 17 17 11 11 17 11 17 17 17 17 17 17 11 17 11 16 11 49 11 28 29 30 17 49 18 11 11 12 50 33 31 14 14 14 36 
14 36 14 14 31 31 33 10 17 17 11 11 17 17 17 11 11 11 17 17 17 17 40 40 40 17 17 17 17 17 11 11 17 11 11 17 17 17 17 40 40 11 11 11 16 11 17 11 37 38 39 17 11 18 11 11 12 33 31 31 14 14 36 36 
14 14 14 14 14 31 33 19 45 17 17 11 11 17 11 11 11 17 17 40 40 40 40 17 40 17 17 17 11 11 11 17 17 11 17 17 40 40 40 40 17 17 17 17 16 11 11 11 46 47 48 17 11 18 11 17 12 33 31 14 14 36 36 14 
14 14 14 14 14 31 33 50 10 17 11 17 11 11 11 11 17 17 40 40 17 17 17 17 40 17 17 17 17 17 17 17 17 11 17 40 40 17 17 17 17 17 17 17 16 11 11 17 17 17 11 17 11 18 17 44 21 33 31 14 14 14 14 14 
14 14 14 14 14 31 31 33 19 45 11 11 11 11 11 17 17 17 17 17 17 17 17 17 40 17 17 17 17 17 17 17 11 11 40 40 17 17 28 29 30 11 11 17 25 26 26 26 26 26 26 26 26 27 17 12 50 33 31 14 14 14 14 14 
14 14 14 36 14 14 31 33 33 10 17 11 17 11 11 11 11 17 17 17 17 17 17 17 40 17 17 17 11 11 17 17 11 17 40 17 17 17 37 38 39 11 11 17 17 17 17 17 17 17 11 11 11 11 44 21 33 31 31 14 14 14 14 36 
14 14 36 36 14 14 31 31 33 19 45 11 17 17 11 11 11 11 17 17 11 11 11 17 40 17 17 11 11 11 11 17 11 17 40 40 17 17 46 47 48 11 11 17 17 11 17 17 17 11 11 11 11 44 21 33 33 31 14 14 14 14 36 36 
14 14 36 14 14 14 31 31 33 50 10 11 11 17 11 11 17 17 17 17 11 17 11 17 17 17 11 28 29 30 11 11 11 17 17 40 17 17 17 17 17 17 17 17 11 11 17 11 11 11 11 17 44 21 50 33 31 31 14 14 14 36 36 14 
14 14 36 14 14 14 14 31 31 33 19 20 20 45 11 11 11 11 11 17 11 17 11 17 17 17 11 37 38 39 17 11 17 17 17 40 17 17 17 17 17 17 17 11 11 17 11 11 11 17 44 20 21 33 33 31 31 14 14 14 36 36 14 14 
14 36 36 14 14 14 14 14 31 33 33 33 50 19 20 20 45 17 11 11 11 11 11 17 17 11 11 46 47 48 17 11 11 17 17 17 17 17 17 17 17 11 11 11 11 11 11 17 44 20 21 33 33 33 31 31 14 14 14 14 36 14 14 14 
14 14 14 14 14 14 14 14 14 31 31 31 33 33 33 33 19 20 45 17 17 11 11 11 11 11 17 17 17 17 17 17 11 17 17 11 11 11 11 11 11 11 17 11 11 11 44 20 21 33 33 33 31 31 31 14 14 14 14 14 14 14 14 14 
14 14 14 14 14 14 36 14 14 14 31 31 31 31 31 33 33 33 19 20 20 20 45 17 17 17 17 17 17 17 17 17 11 11 11 11 11 11 11 11 11 11 11 11 44 20 21 50 33 33 31 31 31 14 14 14 14 14 14 36 14 14 14 14 
14 14 14 14 14 36 36 14 14 14 14 14 14 31 31 31 31 33 33 50 33 33 19 20 20 45 17 17 17 17 17 17 17 17 11 11 11 11 11 11 11 11 44 20 21 33 33 33 31 31 31 14 14 14 14 14 14 14 36 36 14 14 14 14 
14 14 14 14 36 36 14 14 14 36 36 14 14 14 14 31 31 31 31 31 31 33 33 33 33 19 20 20 20 20 20 20 20 20 20 45 17 17 17 44 20 20 21 33 33 33 31 31 31 14 14 14 14 14 14 14 14 36 36 14 14 14 14 14 
14 14 14 14 36 14 14 14 36 36 14 14 14 14 14 14 14 14 31 31 31 31 31 31 33 33 33 33 33 33 50 33 33 33 33 19 20 20 20 21 33 33 33 33 31 31 31 14 14 14 14 14 14 14 14 14 36 36 14 14 14 14 14 14 
14 14 14 36 36 14 14 14 36 14 14 14 14 14 14 14 14 14 14 14 14 14 14 14 31 31 31 31 31 31 31 31 31 31 33 33 33 50 33 33 50 31 31 31 31 14 14 14 14 14 14 14 14 14 36 36 36 14 14 14 14 36 14 14 
14 14 14 36 14 14 14 36 36 14 14 14 14 14 14 36 36 14 14 14 14 14 14 14 14 14 14 14 14 14 14 14 14 31 31 31 31 31 31 31 31 31 14 14 14 14 14 14 14 14 36 36 36 36 36 14 14 14 14 14 36 36 14 14 
14 14 36 14 14 14 36 36 14 14 14 14 36 36 36 36 14 14 14 14 14 14 36 36 36 14 14 14 14 14 14 14 14 14 14 14 14 14 14 14 14 14 14 14 14 14 14 14 14 36 36 14 14 14 14 14 14 14 14 36 36 14 14 14 
14 14 36 14 14 14 14 14 14 14 36 36 36 14 14 14 14 14 14 36 36 36 36 14 14 14 14 14 14 36 36 14 14 14 14 14 14 14 14 14 14 14 14 14 14 14 14 14 14 36 14 14 14 14 14 36 36 36 36 36 14 14 14 14 
14 14 14 14 14 14 14 14 14 36 36 14 14 14 14 14 36 36 36 36 14 14 14 14 36 36 36 36 36 36 14 14 14 14 14 14 14 14 14 14 14 14 14 14 14 14 14 14 14 36 14 14 14 14 14 36 14 14 14 14 14 14 14 14 
14 14 14 14 14 14 14 14 14 14 14 14 14 14 14 14 36 14 14 14 14 14 14 14 14 14 14 14 14 14 14 14 14 14 14 14 14 14 14 14 14 14 14 14 14 14 14 14 14 14 14 14 14 14 14 14 14 14 14 14 14 14 14 14