25 25 25 25 25 25 25 25 25 25 25 25 25 25 25 25 25 25 25 25 25 25 25 25 25 25 25 25 25 25 25 25 25 25 25 25 25 25 25 25 25 25 25 25 25 25 25 25 25 25 25 25 25 25 25 25 25 25 25 25 25 25 25 25
25 25 25 25 25 25 25 25 25 25 25 25 25 25 25 25 25 25 25 25 25 25 25 25 25 25 25 25 25 25 25 25 25 25 25 25 25 25 25 25 25 25 25 25 25 25 25 25 25 25 25 25 25 25 25 25 25 25 25 25 25 25 25 25
25 25 22 22 37 22 22 37 22 22 22 22 37 37 22 22 22 22 37 37 22 22 22 22 22 22 22 22 22 22 22 22 22 22 22 22 22 22 22 22 22 22 22 22 22 22 22 22 22 22 22 22 22 22 22 22 22 22 22 22 22 22 25 25
25 25 22 22 22 22 22 22 22 22 22 22 22 22 22 35 22 22 22 22 22 22 37 22 22 22 22 22 22 22 22 22 22 22 22 22 22 22 22 22 22 22 22 22 22 22 22 22 22 22 22 22 22 22 22 22 22 22 22 22 22 22 25 25
25 25 22 22 22 35 22 22 22 35 22 22 22 22 22 22 22 22 22 22 22 22 22 22 22 22 22 22 22 22 22 22 22 22 22 22 22 22 22 22 22 22 22 22 22 22 22 22 22 22 22 22 22 22 22 22 22 22 22 22 22 22 25 25
25 25 22 22 22 22 22 22 22 22 22 22 36 22 22 22 22 22 35 22 22 22 22 22 22 22 22 22 22 22 22 22 22 22 22 22 22 22 22 22 22 22 22 22 22 22 22 22 22 22 22 22 22 22 22 22 22 22 22 22 22 22 25 25
25 25 22 22 22 22 22 22 22 22 22 22 22 22 22 22 22 22 22 22 22 35 22 22 22 22 22 22 22 22 22 22 22 22 22 22 22 22 22 22 22 22 22 22 22 22 22 22 22 22 22 22 22 22 22 22 22 22 22 22 22 22 25 25
25 25 22 22 22 35 22 22 22 22 22 36 22 22 36 22 22 36 22 22 22 22 22 22 37 22 22 22 22 22 22 22 22 22 22 22 22 22 22 22 22 22 22 22 22 22 22 22 22 22 22 22 22 22 22 22 22 22 22 22 22 22 25 25
25 25 22 22 22 22 22 35 22 22 22 22 22 22 22 22 22 22 22 22 22 22 22 22 37 22 22 22 22 22 22 22 22 22 22 22 22 22 22 22 22 22 22 22 22 22 22 22 22 22 22 22 22 22 22 22 22 22 22 22 22 22 25 25
25 25 22 22 22 22 22 22 36 36 22 22 22 22 22 22 22 22 22 22 22 22 22 22 22 22 22 22 22 22 22 22 22 22 22 22 22 22 22 22 22 22 22 22 22 22 22 22 22 22 22 22 22 22 22 22 22 22 22 22 22 22 25 25
25 25 22 35 22 22 22 22 22 22 22 22 22 22 22 22 22 22 36 22 22 35 22 22 22 22 22 22 22 22 22 22 22 22 22 22 22 22 22 22 22 22 22 22 22 22 22 22 22 22 22 22 22 22 22 22 22 22 22 22 22 22 25 25
25 25 22 22 22 22 22 36 22 22 22 22 22 22 22 22 22 22 22 22 22 35 22 22 22 22 22 22 22 22 22 22 22 22 22 22 22 22 22 22 22 22 22 22 22 22 22 22 22 22 22 22 22 22 22 22 22 22 22 22 22 22 25 25
25 25 22 22 36 22 36 22 22 22 22 22 22 22 22 22 22 34 36 22 22 22 22 22 22 22 22 22 22 22 22 22 22 22 22 22 22 22 22 22 22 22 22 22 22 22 22 22 22 22 22 22 22 22 22 22 22 22 22 22 22 22 25 25
25 25 22 22 22 36 22 22 22 22 22 22 22 22 22 22 22 36 22 22 22 22 22 22 22 22 22 22 22 22 22 22 22 22 22 22 22 22 22 22 22 22 22 22 22 22 22 22 22 22 22 22 22 22 22 22 22 22 22 22 22 22 25 25
25 25 35 22 22 36 22 22 22 22 22 22 22 22 22 22 22 22 22 22 22 22 22 22 37 22 22 22 22 22 22 22 22 22 22 22 22 22 22 22 22 22 22 22 22 22 22 22 22 22 22 22 22 22 22 22 22 22 22 22 22 22 25 25
25 25 22 22 22 36 22 22 22 22 22 22 22 22 22 22 22 36 22 22 35 22 22 22 22 22 22 22 22 22 22 22 22 22 22 22 22 22 22 22 22 22 22 22 22 22 22 22 22 22 17 22 22 22 22 22 22 22 22 22 22 22 25 25
25 25 22 22 22 22 22 22 22 22 22 22 22 22 22 22 22 22 22 22 22 22 22 22 22 22 22 22 22 22 22 22 22 22 22 22 22 22 22 22 22 22 22 22 22 22 22 22 17 22 22 22 22 22 22 22 22 22 22 22 22 22 25 25
25 25 35 22 36 22 22 22 22 22 22 22 22 22 22 22 22 22 22 22 22 37 22 22 22 22 22 22 22 22 22 22 22 22 22 22 22 22 22 22 22 22 22 22 22 22 22 22 22 22 22 22 22 22 22 22 22 22 22 22 17 22 25 25
25 25 35 22 22 22 22 22 22 22 22 22 22 22 22 22 36 22 22 22 22 22 22 22 22 22 22 22 22 22 22 22 22 22 22 22 22 22 22 22 22 22 22 22 22 22 22 22 22 22 22 22 22 22 22 22 22 22 22 22 22 22 25 25
25 25 22 22 22 22 22 22 22 22 22 22 22 22 34 22 22 22 34 35 22 22 88 42 42 42 42 42 42 42 42 42 42 42 42 42 42 42 42 42 42 42 42 89 22 22 22 22 22 22 22 22 22 17 22 22 22 22 22 22 22 22 25 25
25 25 22 22 36 22 22 22 22 22 22 22 22 22 22 22 22 22 22 22 22 22 23 66 66 66 66 66 66 66 66 66 66 66 66 66 66 66 66 66 66 66 66 21 22 22 17 22 22 22 22 22 17 17 22 22 22 22 22 22 22 22 25 25
25 25 22 35 22 22 22 22 22 22 22 22 22 36 22 22 22 22 22 22 37 37 23 66 1 2 2 2 2 2 2 2 2 2 2 2 2 2 2 2 2 3 66 21 22 22 17 22 22 22 22 22 22 22 22 22 22 17 22 22 22 22 25 25
25 25 22 35 22 22 36 22 22 36 35 22 22 22 22 22 22 22 35 22 22 22 23 66 21 54 22 22 22 22 56 22 22 22 22 55 22 22 22 55 22 23 66 21 22 22 22 22 22 22 22 17 22 22 22 22 22 22 22 22 22 22 25 25
25 25 22 22 22 22 22 22 22 22 35 22 22 22 22 22 22 37 22 22 22 22 23 66 21 22 22 57 14 22 22 22 56 22 22 22 56 56 22 14 22 23 66 21 22 22 22 22 22 22 22 22 22 22 22 22 22 22 22 22 22 22 25 25
25 25 22 35 22 22 22 22 22 22 22 22 22 22 22 22 22 22 22 22 22 22 23 66 21 22 56 22 22 22 55 22 22 22 55 22 22 22 22 22 22 23 66 21 22 17 17 22 22 22 22 22 22 22 22 22 22 22 22 22 22 22 25 25
25 25 22 22 22 22 22 22 35 35 22 37 22 22 22 22 22 22 22 22 22 22 23 66 21 22 22 22 22 22 22 56 54 22 22 22 22 22 14 22 55 23 66 21 22 22 22 22 22 22 22 22 22 22 22 22 22 22 22 22 22 22 25 25
25 25 22 22 22 22 22 22 22 22 22 22 22 22 22 22 22 22 22 22 22 22 23 66 21 22 57 22 22 22 22 22 22 22 22 22 22 22 22 54 22 23 66 21 22 22 22 22 22 22 22 22 22 22 22 22 22 17 22 22 22 22 25 25
25 25 37 22 22 22 22 37 22 22 22 22 22 22 22 22 22 22 22 22 22 22 23 66 21 22 22 22 22 22 22 22 22 22 22 22 22 22 22 22 22 23 66 21 22 22 17 17 22 22 17 22 22 22 22 22 22 17 22 17 22 22 25 25
25 25 22 22 22 22 22 22 22 22 22 22 22 22 22 22 22 22 22 22 22 22 23 66 21 14 22 22 14 22 22 25 25 25 25 22 22 22 22 22 14 23 66 21 22 22 17 17 22 22 22 17 17 17 17 22 22 17 17 22 22 22 25 25
25 25 22 22 22 22 22 22 22 22 22 22 22 22 22 22 22 22 22 22 22 22 23 66 21 22 22 22 22 22 22 25 25 105 25 22 22 22 22 22 22 23 66 21 22 22 22 22 22 17 22 22 22 22 22 22 22 22 22 22 17 22 25 25
25 25 22 22 22 22 22 22 22 22 22 22 22 22 22 22 22 22 22 22 22 22 23 66 21 22 22 22 22 22 22 86 87 25 25 22 22 22 22 22 22 23 66 21 22 22 22 22 22 17 22 22 14 17 22 22 17 22 22 22 22 22 25 25
25 25 22 22 22 22 22 22 22 22 22 22 22 22 22 22 22 22 22 22 22 22 23 66 21 22 22 22 22 22 22 106 107 25 25 22 22 22 22 22 22 23 66 21 22 17 22 22 14 14 22 22 22 22 22 17 17 22 22 22 22 22 25 25
25 25 22 22 22 22 22 22 22 22 22 22 22 22 22 22 22 22 22 22 22 22 23 66 21 22 22 22 22 22 22 22 22 22 22 22 22 14 22 22 22 23 66 21 22 22 22 22 22 22 22 17 22 22 22 22 22 17 17 14 22 22 25 25
25 25 22 22 22 22 22 22 22 22 22 22 22 22 22 22 22 22 22 22 22 22 23 66 21 22 22 22 22 22 22 22 22 22 22 22 22 22 22 22 22 23 66 21 22 22 14 22 22 22 22 17 17 22 22 22 22 22 22 22 22 22 25 25
25 25 22 22 22 22 22 22 22 22 22 22 22 22 22 22 22 22 22 22 22 22 23 66 21 22 22 22 22 22 22 14 22 22 22 22 22 22 22 22 22 23 66 21 22 22 14 22 22 17 17 22 17 17 22 77 22 22 22 17 22 22 25 25
25 25 22 22 22 22 22 22 22 22 22 22 22 22 22 22 22 22 22 22 22 22 23 66 21 22 22 22 14 22 22 22 22 22 22 22 22 22 22 22 22 23 66 21 22 22 22 22 22 22 22 22 14 22 22 22 22 22 14 22 22 22 25 25
25 25 22 22 22 22 22 22 22 22 22 22 22 22 22 22 22 22 22 22 22 22 23 66 21 22 22 22 22 22 22 22 22 22 22 22 22 22 22 22 22 23 66 21 14 14 14 14 22 22 22 17 17 22 22 22 22 22 22 17 22 22 25 25
25 25 22 22 22 22 22 22 22 22 22 22 22 22 22 22 22 22 22 22 22 22 23 66 21 22 14 22 22 22 22 22 22 22 22 22 22 22 22 14 22 23 66 21 22 22 22 22 22 22 22 17 77 22 22 22 22 22 17 17 22 22 25 25
25 25 22 22 22 22 22 22 22 22 22 22 22 22 22 22 22 15 22 22 22 22 23 66 41 42 42 42 42 42 42 42 42 42 42 42 42 42 42 42 42 43 66 21 22 22 17 17 77 22 22 22 22 22 22 22 75 22 22 22 22 22 25 25
25 25 22 22 22 22 22 22 22 22 22 22 22 55 22 22 22 22 22 22 22 22 23 66 66 66 66 66 66 66 66 66 66 66 66 66 66 66 66 66 66 66 66 21 22 22 17 22 22 22 22 17 76 22 22 22 22 22 22 22 22 22 25 25
25 25 22 22 22 22 22 22 22 22 55 22 22 22 22 15 22 15 15 22 22 22 108 2 2 2 2 2 2 2 2 2 2 2 2 2 2 2 2 2 2 2 2 109 22 22 22 77 22 22 22 22 77 77 77 22 22 22 22 22 22 22 25 25
25 25 22 22 55 15 15 22 22 22 22 22 22 22 22 22 22 55 15 15 22 22 22 22 15 15 22 22 22 22 22 22 22 22 22 22 22 22 22 22 22 22 22 22 22 22 17 22 22 22 22 22 22 22 22 22 22 22 77 22 22 22 25 25
25 25 22 22 55 22 22 55 25 25 25 25 25 25 25 25 25 25 25 22 22 22 22 55 22 35 35 22 22 15 15 15 22 22 22 22 22 22 22 22 22 22 22 22 22 22 22 22 22 22 22 75 22 22 22 22 22 22 75 22 22 22 25 25
25 25 22 22 22 22 22 28 25 213 213 213 213 213 213 213 213 213 25 25 25 25 25 25 25 25 25 25 22 55 15 22 22 22 22 22 22 22 22 22 22 22 22 77 77 22 22 22 75 76 77 22 77 22 22 77 22 22 77 77 22 22 25 25
25 25 22 22 22 55 22 25 25 213 213 213 213 213 213 213 213 213 213 213 213 213 213 213 213 213 213 25 25 25 22 35 22 22 22 75 22 22 75 77 22 22 22 22 22 22 22 22 22 22 77 22 77 22 22 22 22 22 77 22 22 22 25 25
25 25 22 22 22 22 25 25 213 213 213 213 213 213 213 213 213 213 213 213 213 213 213 213 213 213 213 213 213 25 25 22 22 22 22 22 22 22 77 22 22 76 22 22 22 22 22 22 22 76 22 22 77 22 77 22 22 22 77 22 22 22 25 25
25 25 22 22 22 22 213 213 213 213 213 213 213 213 213 213 213 213 28 28 28 28 213 67 67 67 213 213 213 213 25 22 22 35 22 22 22 76 76 22 22 76 77 77 77 22 77 22 22 22 22 22 75 22 75 77 77 22 22 76 22 22 25 25
25 25 22 22 15 22 213 213 213 213 213 67 67 213 213 67 67 213 28 28 28 28 213 213 213 67 67 213 213 213 25 25 22 35 22 22 22 22 22 22 22 22 22 22 22 22 77 77 22 22 22 22 77 77 77 77 75 22 22 22 22 22 25 25
25 25 22 22 22 22 213 213 213 213 213 67 213 213 213 213 213 213 55 55 28 28 213 213 213 213 67 67 67 67 213 25 22 22 22 22 22 22 77 22 22 22 22 22 22 22 22 22 22 22 74 22 22 74 22 22 22 22 22 22 22 22 25 25
25 25 22 22 22 22 213 213 213 213 213 213 213 213 213 213 213 213 28 28 28 28 213 213 213 105 213 213 213 213 213 25 22 22 22 22 22 22 22 22 22 77 22 74 75 22 74 75 22 22 76 22 22 75 22 76 77 22 76 22 22 22 25 25
25 25 55 22 22 22 213 213 213 213 213 213 213 213 213 213 213 213 213 213 213 67 67 213 213 213 213 213 213 213 213 25 22 22 35 22 22 22 76 22 22 22 22 77 75 74 22 22 22 77 74 75 77 74 74 75 22 22 76 22 22 22 25 25
25 25 22 22 22 22 22 213 213 213 213 213 213 213 213 213 67 67 213 213 67 67 213 213 213 213 213 213 213 213 213 25 22 35 35 22 22 22 22 22 22 22 76 22 22 22 77 77 75 22 74 77 77 75 22 22 22 74 76 22 22 22 25 25
25 25 22 22 15 22 22 22 213 213 213 213 213 213 67 67 67 67 67 67 67 213 213 213 213 105 213 213 213 213 213 25 22 74 22 22 75 22 22 22 22 22 22 22 22 22 75 74 77 22 74 75 22 22 22 22 22 22 22 22 22 22 25 25
25 25 22 22 22 22 22 22 22 213 213 213 213 213 67 213 213 213 67 67 213 213 213 213 213 213 213 213 25 25 25 25 22 22 22 22 22 22 22 22 22 22 22 76 22 77 22 75 22 74 75 76 22 22 74 22 22 22 22 22 75 22 25 25
25 25 22 22 22 22 22 22 22 213 213 213 213 213 213 213 213 213 213 213 213 213 105 213 213 213 213 213 25 25 22 35 35 22 22 74 74 22 76 76 76 22 77 22 74 77 75 22 22 22 22 75 22 22 74 75 22 22 22 22 22 22 25 25
25 25 22 22 22 22 15 22 22 22 22 213 213 213 213 213 213 213 213 213 213 213 213 213 213 213 213 213 25 22 22 35 22 15 22 22 22 22 76 22 22 22 22 74 75 75 22 74 22 22 22 22 74 22 22 22 76 75 22 22 22 22 25 25
25 25 22 22 22 22 15 22 22 22 22 22 213 213 213 213 213 213 213 213 213 213 213 213 213 213 22 22 22 22 22 22 22 74 22 22 22 22 77 22 22 74 22 76 75 22 22 22 22 22 22 22 74 75 22 22 22 22 22 22 22 22 25 25
25 25 22 22 22 22 22 15 22 22 22 22 25 213 213 213 213 213 213 213 213 213 213 213 22 22 22 22 22 74 22 22 22 22 22 76 76 22 22 22 22 22 22 22 77 22 76 22 75 76 22 74 76 75 22 22 74 22 22 22 76 22 25 25
25 25 22 22 22 22 22 15 22 22 22 22 15 22 22 22 213 213 213 213 213 22 22 22 22 15 15 15 15 22 22 74 22 22 22 76 22 22 22 22 22 22 22 22 22 22 74 75 75 77 75 76 76 22 75 76 75 22 76 76 75 22 25 25
25 25 22 22 22 22 22 22 22 22 22 22 22 22 22 22 22 22 22 22 15 15 22 22 22 22 22 22 22 22 22 74 22 22 22 22 22 22 22 22 22 22 22 22 22 22 22 22 22 22 22 22 22 22 75 22 22 22 22 22 75 22 25 25
25 25 22 22 22 22 22 22 22 22 22 22 22 22 22 22 22 22 22 22 22 22 22 22 22 22 22 22 22 22 22 22 22 22 22 22 22 22 22 22 22 22 22 22 22 22 22 22 22 22 22 22 22 22 22 22 22 22 22 22 22 22 25 25
25 25 22 22 22 22 22 22 22 22 22 22 22 22 22 22 22 22 22 22 22 22 22 22 22 22 22 22 22 22 22 22 22 22 22 22 22 22 22 22 22 22 22 22 22 22 22 22 22 22 22 22 22 22 22 22 22 22 22 22 22 22 25 25
25 25 25 25 25 25 25 25 25 25 25 25 25 25 25 25 25 25 25 25 25 25 25 25 25 25 25 25 25 25 25 25 25 25 25 25 25 25 25 25 25 25 25 25 25 25 25 25 25 25 25 25 25 25 25 25 25 25 25 25 25 25 25 25
25 25 25 25 25 25 25 25 25 25 25 25 25 25 25 25 25 25 25 25 25 25 25 25 25 25 25 25 25 25 25 25 25 25 25 25 25 25 25 25 25 25 25 25 25 25 25 25 25 25 25 25 25 25 25 25 25 25 25 25 25 25 25 25